,Price,Transmission,Power,Engine CC,Male,Female,Unknown,Total,Fuel_2.0
0,30.61932203,5.966101695,94.03389831,1497.169492,814172,422731,56487,1293390,0
1,18.53214286,5.714285714,68.57142857,1166.142857,554879,631666,54057,1240602,0
2,31.24215385,6.164835165,89.46153846,1537.406593,483216,310604,47563,841383,0
3,22.1,5.615384615,75.57692308,1219.653846,241287,312556,28004,581847,0
4,47.84837037,6.444444444,126.1111111,1995.777778,408016,115843,29125,552984,0
5,18.1925,5.074074074,60.96296296,1408.055556,216333,299110,31701,547144,0
6,20.03375,4.833333333,71.33333333,1631.5,178698,250614,26135,455447,0
7,39.97375,1.75,130.25,1998.5,357452,69603,16550,443605,0
8,20.3776087,4.869565217,67.95652174,1279.695652,143218,253000,26619,422837,0
9,29.942625,4.5,106.225,1480.575,242188,132958,21042,396188,0
10,15.46,5.0,60.8,1196.0,102708,269428,20324,392460,0
11,26.4498867,5.408866995,87.31034483,1623.793103,209379,156607,21049,387035,0
12,20.7206,3.52,74.4,1397.8,137907,214944,27670,380521,0
13,46.5274,7.04,131.6,1596.92,209476,69373,17242,296091,0
14,57.92693548,6.161290323,149.7096774,2283.112903,202037,59936,13629,275602,0
15,46.06451282,6.487179487,125.4358974,1835.846154,211510,48599,14505,274614,0
16,26.3525,0.0,80.0,1498.0,105551,136875,15698,258124,0
17,36.21929825,6.473684211,94.33333333,1424.666667,144962,97033,14460,256455,0
18,27.46483636,4.872727273,86.45454545,1723.0,132728,108991,14395,256114,0
19,21.70216667,4.9,79.76666667,1536.0,99472,138839,13442,251753,0
20,22.36209302,4.88372093,72.58139535,1743.44186,145377,87029,11519,243925,0
21,19.00794118,5.205882353,66.97058824,1292.352941,109408,87532,10776,207716,0
22,37.4265,6.2,104.2,1796.6,103719,87660,11806,203185,0
23,43.86363077,5.292307692,105.1692308,2083.523077,118279,59369,9921,187569,1
24,22.90364865,5.405405405,75.64864865,1364.0,78551,98254,9893,186698,0
25,27.23911864,3.033898305,91.61016949,1677.949153,104996,67184,12042,184222,0
26,93.71425,8.0,225.0,2979.0,138584,21302,9443,169329,0
27,37.31523077,4.323076923,103.6769231,1873.261538,123806,29728,9574,163108,0
28,78.07322727,7.672727273,192.4,2598.818182,125070,24029,9465,158564,0
29,32.06304348,5.956521739,89.34782609,1472.826087,85989,62467,8346,156802,1
30,19.93814035,5.649122807,76.31578947,1205.192982,74717,73895,6282,154894,0
31,107.4521429,8.0,182.5714286,2425.428571,112207,29981,6388,148576,1
32,107.6705126,8.277310924,196.3361345,2521.092437,107520,34079,6847,148446,1
33,34.93603125,5.25,97.71875,1820.65625,79290,56539,8830,144659,1
34,30.65053846,6.346153846,95.0,1136.692308,110428,25662,6147,142237,0
35,26.29166667,5.6,74.73333333,1186.333333,30349,102113,8177,140639,1
36,31.1045119,4.547619048,93.01190476,1699.119048,55510,68928,9727,134165,0
37,22.78208333,4.916666667,81.66666667,1847.666667,78034,44706,7892,130632,0
38,29.26025,5.95,90.625,1462.3625,79604,42130,5547,127281,0
39,24.09525,6.25,68.75,1498.25,29548,87974,7427,124949,0
40,43.54851613,1.35483871,137.7741935,2261.193548,59395,54005,8166,121566,0
41,49.28583333,6.0,145.0,1963.666667,84741,27948,6616,119305,0
42,11.14333333,5.0,50.0,998.0,32821,73891,5917,112629,0
43,15.20916667,5.0,53.0,998.0,33395,66147,7814,107356,0
44,16.011,5.0,51.77777778,998.0,39242,63346,4208,106796,0
45,82.06090909,7.727272727,199.7272727,2790.454545,85861,15146,5507,106514,1
46,16.59192308,5.0,52.84615385,998.0,36803,64725,3857,105385,0
47,19.31857143,5.0,66.42857143,1348.285714,54195,41756,5908,101859,1
48,32.93965169,6.348314607,114.8202247,1615.370787,65505,30221,3778,99504,0
49,65.56875,8.0,167.25,1998.0,79176,13946,3968,97090,0
50,19.37890909,4.863636364,61.27272727,1470.909091,51517,41027,4395,96939,0
51,39.39984314,5.784313725,117.7058824,2151.647059,74157,15889,5274,95320,0
52,37.46857143,5.857142857,103.4285714,1718.571429,47900,39519,5986,93405,0
53,42.66935185,5.907407407,118.1851852,2095.185185,71632,17216,4536,93384,0
54,13.48615385,5.0,52.38461538,1028.923077,30691,57228,4503,92422,0
55,19.08518182,3.727272727,68.90909091,1180.545455,34918,49829,6070,90817,0
56,53.78571429,6.0,124.8571429,1855.0,60515,24893,5151,90559,1
57,32.33086957,5.891304348,103.1086957,1482.5,50045,36010,4024,90079,0
58,30.99513158,5.789473684,101.8947368,1905.631579,52309,32724,4647,89680,0
59,64.59222222,6.777777778,178.5555556,2011.555556,45707,37950,5714,89371,0
60,34.02059211,5.552631579,99.0,1920.026316,66613,16346,3850,86809,1
61,21.6,6.0,64.625,1496.0,29852,51314,5032,86198,0
62,10.42388889,5.0,52.44444444,1095.777778,34789,42772,4671,82232,0
63,26.97346154,3.076923077,85.69230769,1515.282051,47251,30032,4747,82030,0
64,18.64264,4.84,67.0,1698.64,50801,26596,3897,81294,0
65,12.35588235,4.647058824,53.88235294,1366.294118,41148,35920,3722,80790,0
66,50.96109091,6.181818182,135.2909091,1971.163636,59903,14323,4431,78657,1
67,12.32981818,4.818181818,53.81818182,1367.272727,38039,33281,3354,74674,0
68,32.98557692,6.230769231,94.03846154,1528.807692,41330,24181,4531,70042,1
69,33.25025,6.166666667,112.75,1475.0,16475,48750,4776,70001,0
70,22.95871429,6.285714286,80.0,998.0,36610,28881,2239,67730,0
71,32.1815,6.0,99.0,1448.6,39067,22899,2336,64302,0
72,113.2693333,8.0,246.3333333,2994.666667,45819,14588,3268,63675,1
73,28.23090909,6.454545455,86.0,999.0,24663,32045,5707,62415,0
74,26.803,5.428571429,85.71428571,1310.0,34682,23094,3559,61335,0
75,26.97522727,5.863636364,88.09090909,1460.795455,37398,20296,1991,59685,0
76,28.60820513,4.756410256,92.82051282,2043.820513,46504,9985,2693,59182,0
77,13.63642857,4.714285714,69.0,1424.857143,24389,31656,2947,58992,0
78,47.361875,3.75,113.375,1774.8125,41540,14753,2532,58825,1
79,72.79589474,6.210526316,166.3157895,3041.0,38415,16438,3538,58391,0
80,35.28132353,5.176470588,113.3529412,2106.5,41358,13625,3194,58177,0
81,39.35238095,5.0,98.04761905,1928.714286,46997,8060,2388,57445,0
82,27.4386,6.34,85.28,1452.0,37450,16005,2902,56357,1
83,9.5628,4.6,50.0,996.0,21062,30777,4330,56169,0
84,26.51269565,4.02173913,93.58695652,1933.021739,41096,11421,3286,55803,0
85,21.847,6.090909091,70.72727273,1052.272727,26734,26745,2019,55498,0
86,61.86283333,6.833333333,184.1666667,2748.333333,24741,25424,3794,53959,0
87,47.52333333,6.0,128.8888889,1886.555556,31973,17823,2374,52170,1
88,77.41666667,7.0,188.3333333,2876.0,35260,13819,3081,52160,1
89,43.97,6.6,115.3,1634.2,32328,17864,1642,51834,1
90,38.72769231,5.538461538,114.6538462,2178.192308,40589,8990,2246,51825,1
91,15.14,5.0,64.0,1382.75,21142,27977,2495,51614,0
92,28.60918919,5.945945946,100.5945946,1387.621622,31244,18187,2059,51490,0
93,78.74625,8.0,176.25,1997.0,43857,4860,1940,50657,1
94,27.08277108,6.228915663,86.63855422,1377.566265,17678,29771,2342,49791,0
95,17.03876744,5.302325581,73.48837209,1374.046512,20915,25109,2781,48805,0
96,59.43242424,7.0,150.4545455,1981.818182,35411,9131,2161,46703,0
97,38.7525,0.0,165.0,2488.0,27761,16836,1331,45928,0
98,33.798,0.0,96.0,1797.4,29616,10848,4383,44847,0
99,66.58842105,5.736842105,172.3157895,2934.631579,36990,5033,1853,43876,0
100,36.52419118,5.176470588,113.3529412,2106.5,29574,11687,2481,43742,0
101,16.20874359,4.461538462,63.56410256,1650.205128,31223,10678,1626,43527,0
102,85.82946154,8.0,213.1538462,1969.0,26579,12860,2834,42273,0
103,34.9090566,5.603773585,104.2264151,1805.924528,33777,6565,1831,42173,1
104,35.81481651,6.293577982,117.4311927,1921.46789,28059,10836,2413,41308,0
105,76.5922,8.0,184.0,2396.4,24013,13661,2645,40319,0
106,44.30857143,6.714285714,108.0,1663.928571,23104,14542,1750,39396,0
107,41.38957143,7.285714286,105.7142857,1545.428571,19092,15501,2148,36741,1
108,19.9680625,2.8125,55.375,592.5625,17738,16848,2113,36699,0
109,25.39952941,4.647058824,78.85294118,1891.588235,26706,7942,1758,36406,0
110,23.322,3.75,84.2,1853.9,25441,8533,1547,35521,0
111,158.7922667,7.466666667,293.5333333,3005.4,29960,3418,1599,34977,0
112,137.5695455,8.0,223.5454545,2813.0,30739,2641,1496,34876,0
113,30.5976,1.8,97.6,1757.6,27537,5965,1348,34850,0
114,52.95719388,5.653061224,146.122449,2031.469388,26909,5562,1856,34327,0
115,31.5255,5.166666667,109.6666667,1861.833333,23509,8349,1694,33552,0
116,45.6995,6.0,114.0,1854.2,23214,7747,2551,33512,1
117,44.14181818,6.545454545,144.6363636,2242.636364,22644,9212,1516,33372,1
118,22.84857143,6.523809524,73.23809524,1241.857143,13875,17430,1215,32520,0
119,52.085,8.0,223.8333333,1969.0,25331,4913,1689,31933,0
120,23.35964286,5.25,81.28571429,1410.357143,13057,17367,1231,31655,0
121,17.82333333,4.666666667,70.33333333,1298.666667,13701,15260,1747,30708,0
122,21.02333333,5.0,92.33333333,1729.333333,19477,9964,1264,30705,0
123,39.70773684,4.842105263,117.5789474,2719.842105,19359,9318,1712,30389,1
124,36.01325,6.0,151.6666667,2048.666667,20969,7821,907,29697,0
125,64.109625,6.75,202.125,2778.0,19343,8462,1748,29553,0
126,17.182,5.0,74.0,1994.0,17725,10492,1320,29537,0
127,17.065625,5.125,51.375,999.0,10220,17894,1082,29196,0
128,25.94322222,4.777777778,67.0,1372.666667,14101,12767,1973,28841,0
129,9.492272727,4.909090909,40.81818182,850.2727273,9404,17374,1692,28470,0
130,83.50125,6.5,213.5,3071.0,20033,6312,1597,27942,0
131,9.8628,5.0,50.0,1090.4,12629,12804,1891,27324,0
132,40.98307692,7.307692308,114.2692308,1352.576923,17213,8974,1071,27258,0
133,17.34364706,4.745098039,70.92156863,1683.607843,15999,9404,1566,26969,0
134,30.3775,6.3125,94.0625,935.625,11079,14037,1749,26865,0
135,22.77681818,5.272727273,92.36363636,1837.363636,15843,8974,1340,26157,0
136,33.70615385,6.153846154,120.1538462,1750.615385,17313,6728,1072,25113,0
137,145.6466667,6.0,283.0,5000.0,20604,3013,1154,24771,0
138,27.13,5.768421053,96.05263158,1774.778947,14157,9495,999,24651,1
139,32.4898913,5.304347826,113.2826087,2093.021739,13551,9639,1421,24611,0
140,14.293,4.6,75.4,1479.0,13520,8849,1296,23665,0
141,13.88308333,4.75,47.75,1373.75,8828,12512,1320,22660,0
142,43.06842105,6.254385965,104.2017544,2222.710526,18660,2239,1630,22529,1
143,38.9,5.84,113.84,1926.0,13708,7991,660,22359,1
144,18.76848837,4.860465116,67.02325581,1391.023256,13273,7486,1332,22091,1
145,22.12540909,5.5,75.09090909,1622.681818,12385,8561,1099,22045,0
146,31.30566667,6.259259259,96.92592593,1587.222222,16259,4610,989,21858,0
147,49.82277778,6.0,115.8333333,1746.944444,14659,5610,1284,21553,0
148,59.0,7.0,166.0,1798.0,14370,5657,1245,21272,0
149,19.45142857,3.571428571,61.0,1197.0,9623,10103,1499,21225,0
150,20.6695,4.75,88.0,1586.0,10925,9035,1217,21177,0
151,31.195,6.0,105.875,1755.75,13424,6193,866,20483,0
152,64.50769231,6.846153846,144.2307692,2048.538462,12761,6588,1044,20393,1
153,46.5274,7.04,131.6,1596.92,16634,2550,1069,20253,0
154,20.36464286,5.857142857,82.25,1534.392857,13570,5531,989,20090,1
155,51.646,0.0,110.0,1995.0,13236,5511,1307,20054,0
156,30.351,6.3,83.5,1452.3,13365,5800,883,20048,0
157,94.098125,8.0,190.0,2967.0,14059,4973,906,19938,1
158,8.17,5.0,40.0,1108.0,7901,10570,1075,19546,0
159,39.725,6.8,110.0,1592.0,16399,2367,763,19529,0
160,22.455,6.0,92.30769231,1466.307692,11663,7015,837,19515,0
161,51.44133333,7.2,123.9333333,1863.133333,10717,7442,1268,19427,1
162,106.5488889,8.0,210.0,2976.333333,13244,4579,981,18804,1
163,25.3433871,5.193548387,95.09677419,1802.774194,11552,5743,1064,18359,0
164,34.19,6.0,103.0,1794.0,11658,5595,925,18178,0
165,115.533,8.0,250.0,2998.0,15286,1519,1055,17860,0
166,32.09,4.0,98.2,1754.4,10315,6485,930,17730,0
167,50.94,6.266666667,138.2833333,1986.766667,14400,2261,963,17624,1
168,12.49833333,5.0,48.66666667,1336.666667,6154,10468,995,17617,0
169,14.94,5.2,59.6,958.6,6015,10447,672,17134,0
170,23.01661538,4.730769231,90.88461538,1709.538462,12773,3703,607,17083,0
171,25.17006452,5.516129032,79.30645161,1523.741935,11730,4440,900,17070,1
172,42.2862,6.0,113.8,1740.0,6660,9047,1352,17059,0
173,135.1055,6.5,309.0,3999.0,14930,1383,661,16974,0
174,29.88478947,4.736842105,109.1052632,2238.631579,9477,6366,1029,16872,0
175,18.513,4.6,76.0,1599.0,9531,6321,789,16641,0
176,17.31777778,3.666666667,58.44444444,1152.888889,6539,8634,1288,16461,0
177,264.675,7.0,420.0,6208.0,12431,3121,879,16431,0
178,23.0525,5.0,55.0,1406.0,7516,7685,1211,16412,0
179,39.7374,4.6,115.0,2234.4,9579,5143,969,15691,0
180,52.19640625,5.3125,126.5,2323.9375,10078,4642,893,15613,0
181,20.9225,5.375,68.875,1272.4375,9000,5670,799,15469,0
182,13.1466,4.8,55.4,1144.8,6376,7977,905,15258,0
183,43.08,4.666666667,105.0,2239.666667,10252,3863,1118,15233,0
184,11.389,4.142857143,53.0,1308.285714,6266,7546,811,14623,0
185,18.615,5.2,69.6,1330.4,6945,6839,728,14512,0
186,58.46907407,6.444444444,148.5185185,2174.037037,10247,3053,967,14267,1
187,41.59161538,6.461538462,111.3076923,1624.769231,9004,4687,571,14262,0
188,37.52210345,3.896551724,107.3793103,2084.37931,10398,2989,823,14210,0
189,158.976,8.0,326.0,3295.0,10034,3418,731,14183,0
190,32.898125,5.333333333,116.2916667,2081.375,10882,2428,646,13956,0
191,114.8758333,8.0,235.0,2979.0,11265,1708,694,13667,0
192,11.395,5.0,52.5,1047.75,5142,7685,744,13571,0
193,14.22409091,4.727272727,64.45454545,1353.363636,6012,6758,769,13539,0
194,37.44666667,2.611111111,120.3333333,2085.055556,8910,3970,620,13500,0
195,9.465666667,4.666666667,50.0,996.0,4700,8094,615,13409,0
196,33.12857143,5.285714286,103.0,1914.714286,7167,5292,782,13241,0
197,14.333375,4.5625,59.875,1183.25,5141,7106,739,12986,0
198,7.92,4.0,33.33333333,868.3333333,7690,4739,550,12979,0
199,23.58666667,5.25,81.16666667,1509.75,7343,5303,290,12936,0
200,26.0,5.0,70.0,1597.0,2304,9672,899,12875,0
201,11.370625,5.0,48.0,1518.0,7729,4375,640,12744,0
202,37.01736842,4.736842105,97.57894737,2697.368421,9143,3027,569,12739,1
203,23.16515789,3.947368421,82.15789474,1817.315789,7314,4690,716,12720,0
204,22.69,4.8,82.2,1773.7,9003,3084,630,12717,0
205,18.76285714,4.714285714,80.42857143,1612.928571,8102,3942,666,12710,0
206,42.74666667,5.0,128.5,2548.833333,10660,1541,405,12606,0
207,42.5595,6.166666667,131.6666667,2313.666667,6065,5405,737,12207,0
208,108.7471951,7.853658537,207.6097561,2304.97561,9293,2167,668,12128,1
209,13.70454545,4.818181818,47.45454545,1384.0,4800,6549,573,11922,0
210,30.99,0.0,105.0,335.0,8948,2277,392,11617,0
211,32.723,3.6,96.0,1498.0,6436,4377,715,11528,0
212,13.2053,6.0,35.8,679.0,4946,5197,662,10805,0
213,26.19775,4.625,77.0,1495.0,4903,5230,641,10774,0
214,17.44569231,4.692307692,68.26923077,1791.230769,7738,2453,579,10770,0
215,25.2075,5.0,80.5,1753.0,6043,3615,636,10294,0
216,116.545,8.0,230.0,2981.0,8781,749,545,10075,0
217,33.495,0.0,81.0,285.0,5504,4181,383,10068,0
218,12.6825,5.0,45.0,999.0,3867,4960,404,9231,0
219,18.88233333,4.666666667,74.0,1523.333333,5205,3467,543,9215,0
220,285.247,7.2,428.2,5577.8,7602,1024,406,9032,0
221,55.62,6.0,145.75,2460.75,5701,2875,425,9001,0
222,60.9552,5.5,146.0,2588.6,6393,2239,325,8957,1
223,13.11525,4.75,50.875,1430.75,5690,2841,412,8943,0
224,37.00904545,4.590909091,114.6818182,2208.090909,6096,2050,608,8754,0
225,22.91875,5.25,75.5,1288.5,5001,3496,187,8684,0
226,30.236875,4.5,110.0,2316.0,6659,1547,463,8669,0
227,20.37,5.642857143,74.21428571,1324.357143,6234,2009,371,8614,0
228,27.4066,6.0,89.0,1552.0,5033,3351,223,8607,0
229,36.38445588,4.5,125.7058824,2294.764706,6702,1438,427,8567,0
230,22.047,3.6,73.0,1329.0,4955,2986,571,8512,0
231,60.87,6.75,228.0,1984.0,6675,1345,322,8342,0
232,43.26150943,5.905660377,135.3773585,2276.0,6851,1024,383,8258,1
233,13.24516667,4.833333333,66.66666667,1506.5,4259,3305,472,8036,0
234,24.674,0.0,60.0,160.0,3137,4251,578,7966,0
235,45.59125,5.25,104.1666667,2027.833333,4896,2619,420,7935,0
236,20.7195,4.71875,81.375,1950.90625,5710,1753,430,7893,0
237,14.04,5.0,66.0,898.0,4395,3269,209,7873,0
238,45.76307692,5.307692308,109.0769231,2053.0,4829,2435,433,7697,1
239,42.50666667,7.142857143,99.52380952,1294.142857,4563,2622,395,7580,0
240,33.40333333,0.0,110.0,1998.0,4639,2546,320,7505,0
241,84.60125,6.5,220.5,3071.0,5864,1082,362,7308,0
242,70.31925,4.5,199.0,4123.5,6232,767,249,7248,0
243,62.39565385,4.384615385,135.5,2972.307692,5685,1175,385,7245,0
244,24.612,0.0,72.0,1339.0,4587,2144,460,7191,0
245,20.75666667,5.666666667,89.33333333,1332.0,4708,2180,195,7083,0
246,32.73833333,0.0,100.0,1798.0,4220,2112,675,7007,0
247,18.657,5.0,59.58333333,1407.333333,3061,3340,417,6818,0
248,46.85390244,7.707317073,125.0487805,1642.04878,5657,919,231,6807,1
249,24.84390244,4.756097561,84.92682927,1982.756098,5246,1192,346,6784,0
250,38.93888889,6.0,135.5555556,1642.333333,3218,3135,352,6705,0
251,55.4225,6.0,221.0,3498.0,5649,800,218,6667,0
252,14.7754,4.8,51.4,1428.4,3090,2953,397,6440,0
253,55.25,6.0,177.0,1997.0,4891,1201,281,6373,0
254,36.64326667,4.466666667,88.73333333,2284.133333,4841,1082,348,6271,0
255,30.352,4.4,99.0,2117.6,3984,1926,310,6220,0
256,20.20388889,4.777777778,82.33333333,1775.777778,3634,2138,390,6162,0
257,37.350625,5.375,121.0625,1972.8125,4892,989,275,6156,0
258,23.22409091,4.909090909,82.0,1938.0,3819,1990,340,6149,0
259,16.05676923,4.923076923,67.0,1703.153846,3972,1837,300,6109,0
260,50.48413043,7.304347826,150.6086957,1969.0,4321,1290,379,5990,1
261,17.22277778,4.888888889,70.0,1615.333333,3555,2067,364,5986,0
262,95.29916667,6.333333333,253.6666667,3764.333333,4985,692,214,5891,0
263,125.49625,8.0,282.25,3344.75,4371,1148,294,5813,0
264,53.62733333,0.0,122.6666667,2331.333333,4060,1324,410,5794,0
265,26.59125,4.125,108.625,1911.75,3537,1839,271,5647,0
266,29.151,5.0,89.0,2526.5,4054,1123,246,5423,0
267,20.74,5.0,75.0,1695.0,3028,2110,282,5420,0
268,11.74,5.0,63.0,1405.0,2351,2603,398,5352,0
269,19.895,4.8,94.0,1742.6,3240,1779,238,5257,0
270,53.792,6.0,134.3333333,1730.0,4463,462,214,5139,0
271,32.11766667,4.666666667,115.3333333,2362.0,3669,933,224,4826,0
272,24.35,6.0,60.0,698.0,3014,1462,317,4793,0
273,360.755,6.0,410.0,5341.0,4192,359,191,4742,0
274,35.535,6.0,93.6,1647.4,3793,742,139,4674,1
275,28.17,5.583333333,103.0,1706.333333,3389,1045,201,4635,0
276,33.8615625,5.375,116.25,1925.25,3722,659,147,4528,0
277,20.21333333,6.0,74.0,1329.0,2025,2036,296,4357,0
278,11.917,5.0,49.13333333,999.0,1693,2445,189,4327,0
279,87.12,8.0,190.0,2967.0,3715,401,162,4278,1
280,20.43008333,4.791666667,69.875,1773.0,3321,747,148,4216,0
281,21.105625,5.0,60.625,1039.5,2305,1697,180,4182,0
282,35.37645833,6.0,103.0833333,1968.0,3063,867,244,4174,1
283,55.2,6.0,163.5,2696.5,2897,1027,249,4173,0
284,31.1275,5.75,105.25,1688.25,2709,1292,161,4162,0
285,25.29875,4.5,94.0,1998.0,2672,1134,301,4107,0
286,57.22905851,5.234042553,120.4255319,2309.340426,3085,722,260,4067,1
287,36.70125,4.875,91.75,2019.75,2732,1092,220,4044,0
288,18.2955625,4.875,70.25,1836.5,3439,405,90,3934,0
289,273.755,6.0,381.0,5935.0,3354,305,160,3819,0
290,27.09825,4.666666667,91.75,2247.333333,2934,670,181,3785,0
291,19.71783333,4.0,98.0,1995.0,2363,1184,225,3772,0
292,44.62833333,4.333333333,127.6666667,3100.333333,2805,805,101,3711,1
293,134.789,8.0,390.0,4395.0,3327,201,139,3667,0
294,28.803,4.8,111.2,2126.8,2855,663,144,3662,0
295,10.83275,5.0,45.0,1242.0,1935,1492,164,3591,0
296,121.77,6.666666667,316.3333333,3740.0,3101,278,116,3495,0
297,27.94142857,6.214285714,93.35714286,1235.428571,1837,1574,65,3476,0
298,30.839,4.6,121.0,2378.0,2194,1035,224,3453,0
299,56.15916667,5.5,174.3333333,3199.0,2209,1076,162,3447,0
300,27.12333333,6.0,101.0,1497.0,1979,1241,209,3429,0
301,88.77777778,7.0,190.0,3377.444444,2317,857,251,3425,0
302,27.935,5.0,103.5,1833.0,2146,1002,267,3415,0
303,20.31264706,5.352941176,63.29411765,1344.823529,1712,1409,222,3343,1
304,27.78966667,4.666666667,110.6666667,2050.333333,2377,809,153,3339,0
305,19.055,4.6,89.2,1827.8,2299,743,141,3183,0
306,48.09553571,5.107142857,117.7857143,2315.0,2608,406,165,3179,0
307,54.2675,5.666666667,114.0,1998.0,2226,789,148,3163,1
308,46.95322222,6.111111111,126.7777778,1977.166667,2631,414,81,3126,1
309,32.65836364,6.0,101.8181818,1424.727273,756,1999,221,2976,0
310,29.57028571,5.0,84.0,1997.142857,2089,716,170,2975,1
311,41.616,4.6,125.36,2336.52,2362,400,186,2948,0
312,105.465,8.0,257.5,2981.0,2452,349,129,2930,0
313,13.44125,5.0,54.5,1304.0,1782,991,145,2918,0
314,23.16515789,3.947368421,82.15789474,1817.315789,1887,832,174,2893,0
315,31.7425,4.833333333,119.6666667,2116.0,2179,530,142,2851,0
316,11.7129,4.0,69.0,1864.8,2484,259,52,2795,0
317,21.91166667,4.666666667,88.0,1586.0,1376,1249,159,2784,0
318,53.10142857,6.0,163.7142857,2679.285714,2267,362,129,2758,0
319,59.4905,5.0,137.5,2734.5,2352,246,104,2702,0
320,17.31241935,4.967741935,66.35483871,1655.741935,1823,735,137,2695,0
321,35.72526667,4.4,121.0,2287.6,1828,754,111,2693,0
322,43.9745,4.5,98.0,2309.0,1873,665,150,2688,0
323,7.712,5.0,29.0,899.0,1382,1150,142,2674,0
324,25.08266667,4.533333333,93.6,2127.333333,2096,449,110,2655,0
325,16.695,5.0,54.0,1360.0,1592,907,129,2628,0
326,32.4898913,5.304347826,113.2826087,2093.021739,1354,1067,141,2562,0
327,16.4455,4.666666667,78.0,1741.0,1623,711,138,2472,0
328,17.587,4.083333333,73.08333333,1363.5,1524,816,132,2472,0
329,20.27896296,4.111111111,72.85185185,1832.888889,1580,751,126,2457,0
330,78.47722222,0.888888889,224.7777778,3196.555556,2034,252,166,2452,0
331,28.87894737,6.736842105,89.26315789,1262.157895,1391,967,73,2431,0
332,36.90769355,4.5,126.1451613,2344.0,1924,364,110,2398,0
333,59.7575,6.0,147.0,1998.0,1812,422,144,2378,0
334,87.487,0.0,188.0,3498.0,1546,655,131,2332,0
335,24.75629032,5.709677419,81.74193548,1735.580645,1576,622,126,2324,1
336,42.93428571,3.857142857,122.1428571,2308.285714,1507,716,96,2319,0
337,59.05425,6.75,144.375,2417.875,1576,536,174,2286,1
338,30.0062,3.2,115.4666667,2245.6,1757,354,122,2233,0
339,47.881,5.111111111,141.4444444,3106.666667,1573,552,102,2227,1
340,37.471875,5.5,114.5,2167.5,1624,486,102,2212,0
341,15.16166667,4.666666667,75.0,1594.0,1490,595,116,2201,0
342,27.9925,5.5,103.0,1591.0,1240,881,58,2179,0
343,38.48247059,4.882352941,90.94117647,2953.588235,1739,350,88,2177,1
344,21.65952381,5.761904762,90.85714286,1809.714286,1708,346,105,2159,1
345,226.3833333,6.5,368.6666667,4857.0,1882,155,90,2127,0
346,22.49,5.0,80.0,1261.25,572,1361,127,2060,0
347,20.659,5.633333333,73.0,1284.8,1558,421,62,2041,0
348,158.823,4.5,250.0,3228.0,1748,170,113,2031,0
349,35.34,5.0,118.0,1781.0,1754,196,80,2030,0
350,81.295,8.0,250.0,2998.0,1766,188,56,2010,0
351,20.1241875,4.875,79.875,1836.875,1449,418,102,1969,0
352,22.95383333,5.0,67.33333333,1908.166667,1358,505,100,1963,0
353,28.96891667,5.0,72.625,1707.125,1196,579,172,1947,0
354,173.506625,8.0,329.0,3307.25,1639,230,70,1939,0
355,23.8115,5.0,64.0,1298.0,543,1226,153,1922,0
356,13.382,2.5,48.0,1343.0,754,1039,112,1905,0
357,76.71,0.0,336.0,0.0,1527,288,80,1895,0
358,37.72247826,6.0,104.2173913,1684.304348,786,1006,96,1888,0
359,57.22905851,5.234042553,120.4255319,2309.340426,1398,324,131,1853,1
360,40.7645,4.333333333,133.3333333,2634.222222,1409,305,103,1817,0
361,88.46428571,0.0,230.0,3456.0,1264,376,166,1806,0
362,38.025,4.5,129.5,2614.0,1162,536,100,1798,0
363,57.97,7.0,225.0,1998.0,1492,217,73,1782,0
364,30.081,4.0,110.0,2254.0,1193,436,124,1753,0
365,37.04635294,6.0,91.44117647,1773.823529,1386,282,72,1740,1
366,37.773,5.555555556,114.0,2184.0,1109,533,74,1716,1
367,107.6705126,8.277310924,196.3361345,2521.092437,1532,121,52,1705,1
368,146.2746154,5.769230769,234.8461538,4089.923077,1476,121,85,1682,0
369,11.745,5.0,51.0,998.0,770,813,96,1679,0
370,33.43590909,5.636363636,108.3636364,1906.181818,1096,461,119,1676,1
371,37.31220238,5.678571429,102.7261905,2118.940476,1433,148,94,1675,1
372,18.84548718,4.076923077,87.07692308,2326.358974,1461,156,48,1665,0
373,17.325,5.0,55.0,1360.0,938,639,76,1653,0
374,85.05325,6.5,242.0,3696.0,1270,195,46,1511,0
375,175.835,7.0,433.5,4493.5,1264,95,53,1412,0
376,44.852,6.5,170.0,1998.0,843,482,61,1386,0
377,46.60136364,6.0,110.0,2393.0,1105,184,56,1345,1
378,69.397,5.0,173.0,3358.666667,1121,138,75,1334,0
379,88.46428571,0.0,230.0,3456.0,816,430,68,1314,0
380,22.127,5.0,83.0,1721.5,679,520,67,1266,0
381,245.168,6.0,338.0,4691.0,1141,77,46,1264,0
382,30.86290909,4.454545455,105.5454545,2458.909091,1056,152,53,1261,0
383,57.59,5.428571429,121.0,1998.0,793,403,65,1261,1
384,74.609,3.2,239.2,3640.2,1118,95,29,1242,0
385,13.191,5.0,51.33333333,1431.333333,528,597,64,1189,0
386,35.86943902,5.585365854,117.0243902,1980.634146,987,143,45,1175,0
387,34.14,0.0,110.0,320.0,848,248,61,1157,0
388,17.5296,4.6,78.4,1549.8,1008,112,22,1142,0
389,646.605,6.0,450.0,5733.0,975,83,50,1108,0
390,34.33029412,5.588235294,105.0,1962.058824,786,271,49,1106,1
391,35.27,6.0,112.0714286,1574.428571,675,350,79,1104,0
392,177.5,6.0,419.0,3799.0,990,51,41,1082,0
393,42.55733333,6.0,123.2666667,1832.333333,882,160,39,1081,1
394,37.904,6.0,116.08,1998.0,786,259,35,1080,1
395,14.350125,4.875,59.5,1642.875,770,240,46,1056,0
396,37.32636,4.76,101.12,2349.08,830,168,39,1037,0
397,39.721,0.0,91.75,1698.75,605,363,66,1034,0
398,61.235,5.0,147.0,2144.0,928,62,37,1027,0
399,24.84,5.0,102.0,2244.0,781,200,33,1014,0
400,30.61932203,5.966101695,94.03389831,1497.169492,796190,421303,55632,1273125,0
401,18.53214286,5.714285714,68.57142857,1166.142857,533595,613290,51752,1198637,0
402,31.24215385,6.164835165,89.46153846,1537.406593,471514,306459,46958,824931,0
403,22.1,5.615384615,75.57692308,1219.653846,245569,333284,29419,608272,0
404,47.84837037,6.444444444,126.1111111,1995.777778,402404,119094,29479,550977,0
405,18.1925,5.074074074,60.96296296,1408.055556,209196,294044,31568,534808,0
406,20.03375,4.833333333,71.33333333,1631.5,186795,280679,27961,495435,0
407,39.97375,1.75,130.25,1998.5,388535,77687,18006,484228,0
408,20.3776087,4.869565217,67.95652174,1279.695652,151025,265423,27535,443983,0
409,26.4498867,5.408866995,87.31034483,1623.793103,225326,172735,22917,420978,0
410,15.46,5.0,60.8,1196.0,105612,285378,21570,412560,0
411,29.942625,4.5,106.225,1480.575,244214,136414,21581,402209,0
412,20.7206,3.52,74.4,1397.8,127757,204802,26065,358624,0
413,46.5274,7.04,131.6,1596.92,200376,67663,16921,284960,0
414,46.06451282,6.487179487,125.4358974,1835.846154,212442,49082,14718,276242,0
415,57.92693548,6.161290323,149.7096774,2283.112903,198805,59717,13635,272157,0
416,27.46483636,4.872727273,86.45454545,1723.0,138974,115895,14903,269772,0
417,22.36209302,4.88372093,72.58139535,1743.44186,158473,94976,12325,265774,0
418,21.70216667,4.9,79.76666667,1536.0,94625,134494,12382,241501,0
419,26.3525,0.0,80.0,1498.0,98150,126002,14091,238243,0
420,36.21929825,6.473684211,94.33333333,1424.666667,131091,88601,13166,232858,0
421,27.23911864,3.033898305,91.61016949,1677.949153,111626,72304,12747,196677,0
422,19.00794118,5.205882353,66.97058824,1292.352941,101816,81667,9837,193320,0
423,43.86363077,5.292307692,105.1692308,2083.523077,114197,58632,9472,182301,1
424,22.90364865,5.405405405,75.64864865,1364.0,71533,91658,9045,172236,0
425,37.4265,6.2,104.2,1796.6,85622,73966,10002,169590,0
426,37.31523077,4.323076923,103.6769231,1873.261538,128052,30960,9958,168970,0
427,93.71425,8.0,225.0,2979.0,136621,21127,9135,166883,0
428,107.4521429,8.0,182.5714286,2425.428571,114999,30553,6512,152064,1
429,32.06304348,5.956521739,89.34782609,1472.826087,82971,60801,7948,151720,1
430,78.07322727,7.672727273,192.4,2598.818182,118619,22490,9106,150215,0
431,22.78208333,4.916666667,81.66666667,1847.666667,88331,51064,8839,148234,0
432,19.93814035,5.649122807,76.31578947,1205.192982,69228,69142,5781,144151,0
433,30.65053846,6.346153846,95.0,1136.692308,106494,24815,5816,137125,0
434,31.1045119,4.547619048,93.01190476,1699.119048,51512,67384,9522,128418,0
435,107.6705126,8.277310924,196.3361345,2521.092437,94411,26437,5623,126471,1
436,49.28583333,6.0,145.0,1963.666667,88266,29702,6924,124892,0
437,43.54851613,1.35483871,137.7741935,2261.193548,57846,55047,8184,121077,0
438,29.26025,5.95,90.625,1462.3625,71223,37730,4872,113825,0
439,18.64264,4.84,67.0,1698.64,66910,36173,5215,108298,0
440,26.29166667,5.6,74.73333333,1186.333333,25022,75332,6301,106655,1
441,34.02059211,5.552631579,99.0,1920.026316,80809,20063,4727,105599,1
442,39.39984314,5.784313725,117.7058824,2151.647059,80938,17449,5917,104304,0
443,12.35588235,4.647058824,53.88235294,1366.294118,51565,47268,4687,103520,0
444,34.93603125,5.25,97.71875,1820.65625,55455,39048,7595,102098,1
445,82.06090909,7.727272727,199.7272727,2790.454545,79932,14437,5409,99778,1
446,65.56875,8.0,167.25,1998.0,80960,14705,4056,99721,0
447,11.14333333,5.0,50.0,998.0,28808,63323,4917,97048,0
448,12.32981818,4.818181818,53.81818182,1367.272727,47502,44016,4307,95825,0
449,19.37890909,4.863636364,61.27272727,1470.909091,50901,40070,4202,95173,0
450,53.78571429,6.0,124.8571429,1855.0,62488,26340,5249,94077,1
451,37.46857143,5.857142857,103.4285714,1718.571429,46762,41218,6032,94012,0
452,16.59192308,5.0,52.84615385,998.0,33457,56780,3308,93545,0
453,15.20916667,5.0,53.0,998.0,29302,56621,6785,92708,0
454,32.93965169,6.348314607,114.8202247,1615.370787,60942,27912,3413,92267,0
455,42.66935185,5.907407407,118.1851852,2095.185185,70401,17006,4330,91737,0
456,19.31857143,5.0,66.42857143,1348.285714,48036,36158,4404,88598,1
457,16.011,5.0,51.77777778,998.0,32927,49889,3044,85860,0
458,19.08518182,3.727272727,68.90909091,1180.545455,33203,46305,5809,85317,0
459,30.99513158,5.789473684,101.8947368,1905.631579,49655,31335,4231,85221,0
460,64.59222222,6.777777778,178.5555556,2011.555556,43118,35063,5392,83573,0
461,50.96109091,6.181818182,135.2909091,1971.163636,61464,14725,4569,80758,1
462,13.48615385,5.0,52.38461538,1028.923077,27305,48698,3656,79659,0
463,32.33086957,5.891304348,103.1086957,1482.5,44024,31205,3375,78604,0
464,21.6,6.0,64.625,1496.0,27246,45474,4140,76860,0
465,28.60820513,4.756410256,92.82051282,2043.820513,60125,13170,3559,76854,0
466,10.42388889,5.0,52.44444444,1095.777778,31900,38840,4095,74835,0
467,26.97346154,3.076923077,85.69230769,1515.282051,40144,25461,3939,69544,0
468,26.51269565,4.02173913,93.58695652,1933.021739,50957,14240,3959,69156,0
469,33.25025,6.166666667,112.75,1475.0,15748,47347,4588,67683,0
470,39.35238095,5.0,98.04761905,1928.714286,53513,9427,2747,65687,0
471,16.20874359,4.461538462,63.56410256,1650.205128,46180,16891,2544,65615,0
472,32.98557692,6.230769231,94.03846154,1528.807692,38145,22704,4206,65055,1
473,26.803,5.428571429,85.71428571,1310.0,36370,24754,3815,64939,0
474,35.28132353,5.176470588,113.3529412,2106.5,44621,14547,3503,62671,0
475,113.2693333,8.0,246.3333333,2994.666667,44046,14121,3200,61367,1
476,72.79589474,6.210526316,166.3157895,3041.0,39339,17318,3733,60390,0
477,13.63642857,4.714285714,69.0,1424.857143,24971,32414,2806,60191,0
478,22.95871429,6.285714286,80.0,998.0,32920,24567,1934,59421,0
479,47.361875,3.75,113.375,1774.8125,41320,14649,2467,58436,1
480,27.4386,6.34,85.28,1452.0,36270,15661,2708,54639,1
481,38.72769231,5.538461538,114.6538462,2178.192308,42242,9193,2279,53714,1
482,15.14,5.0,64.0,1382.75,21391,29176,2477,53044,0
483,32.1815,6.0,99.0,1448.6,31972,18504,1872,52348,0
484,61.86283333,6.833333333,184.1666667,2748.333333,23022,24753,3626,51401,0
485,77.41666667,7.0,188.3333333,2876.0,33840,13613,2998,50451,1
486,17.03876744,5.302325581,73.48837209,1374.046512,21401,25561,2798,49760,0
487,26.97522727,5.863636364,88.09090909,1460.795455,30071,15945,1514,47530,0
488,66.58842105,5.736842105,172.3157895,2934.631579,39156,5405,1993,46554,0
489,9.5628,4.6,50.0,996.0,17302,24771,3497,45570,0
490,34.9090566,5.603773585,104.2264151,1805.924528,36186,7158,1977,45321,1
491,47.52333333,6.0,128.8888889,1886.555556,27360,15291,1976,44627,1
492,17.182,5.0,74.0,1994.0,26230,15997,2050,44277,0
493,21.847,6.090909091,70.72727273,1052.272727,21175,20167,1454,42796,0
494,23.322,3.75,84.2,1853.9,30561,10334,1853,42748,0
495,35.81481651,6.293577982,117.4311927,1921.46789,28459,10882,2472,41813,0
496,28.60918919,5.945945946,100.5945946,1387.621622,25673,14492,1528,41693,0
497,36.52419118,5.176470588,113.3529412,2106.5,28040,11021,2338,41399,0
498,33.798,0.0,96.0,1797.4,26102,10216,4055,40373,0
499,43.97,6.6,115.3,1634.2,25342,13577,1305,40224,1
500,25.39952941,4.647058824,78.85294118,1891.588235,28811,8835,1970,39616,0
501,78.74625,8.0,176.25,1997.0,34071,3635,1497,39203,1
502,85.82946154,8.0,213.1538462,1969.0,24389,11766,2622,38777,0
503,30.5976,1.8,97.6,1757.6,30041,6655,1528,38224,0
504,52.95719388,5.653061224,146.122449,2031.469388,29522,6099,2027,37648,0
505,28.23090909,6.454545455,86.0,999.0,15328,18390,3564,37282,0
506,31.5255,5.166666667,109.6666667,1861.833333,25664,9441,1946,37051,0
507,38.7525,0.0,165.0,2488.0,22223,13517,1093,36833,0
508,137.5695455,8.0,223.5454545,2813.0,32310,2832,1571,36713,0
509,21.02333333,5.0,92.33333333,1729.333333,22209,12155,1527,35891,0
510,59.43242424,7.0,150.4545455,1981.818182,26700,6813,1613,35126,0
511,76.5922,8.0,184.0,2396.4,20343,12461,2229,35033,0
512,45.6995,6.0,114.0,1854.2,24087,8107,2706,34900,1
513,158.7922667,7.466666667,293.5333333,3005.4,29319,3361,1587,34267,0
514,17.34364706,4.745098039,70.92156863,1683.607843,19790,12060,1962,33812,0
515,30.3775,6.3125,94.0625,935.625,12866,18170,2123,33159,0
516,39.70773684,4.842105263,117.5789474,2719.842105,20696,10212,1793,32701,1
517,52.085,8.0,223.8333333,1969.0,25713,4990,1762,32465,0
518,19.9680625,2.8125,55.375,592.5625,15348,14893,1777,32018,0
519,44.14181818,6.545454545,144.6363636,2242.636364,21659,8872,1386,31917,1
520,41.38957143,7.285714286,105.7142857,1545.428571,16257,13447,1783,31487,1
521,22.77681818,5.272727273,92.36363636,1837.363636,18353,10714,1608,30675,0
522,27.08277108,6.228915663,86.63855422,1377.566265,11917,17246,1305,30468,0
523,17.82333333,4.666666667,70.33333333,1298.666667,13694,14963,1645,30302,0
524,14.293,4.6,75.4,1479.0,16828,11121,1596,29545,0
525,44.30857143,6.714285714,108.0,1663.928571,17019,10821,1364,29204,0
526,9.8628,5.0,50.0,1090.4,13486,13516,1977,28979,0
527,25.94322222,4.777777778,67.0,1372.666667,13704,13083,1951,28738,0
528,9.492272727,4.909090909,40.81818182,850.2727273,9662,17397,1640,28699,0
529,64.109625,6.75,202.125,2778.0,18193,8185,1737,28115,0
530,36.01325,6.0,151.6666667,2048.666667,19736,7240,814,27790,0
531,83.50125,6.5,213.5,3071.0,19388,6335,1576,27299,0
532,59.0,7.0,166.0,1798.0,16898,6793,1429,25120,0
533,13.88308333,4.75,47.75,1373.75,8658,13785,1393,23836,0
534,8.17,5.0,40.0,1108.0,9204,13186,1305,23695,0
535,27.13,5.768421053,96.05263158,1774.778947,13523,8995,902,23420,1
536,32.4898913,5.304347826,113.2826087,2093.021739,12762,9274,1324,23360,0
537,43.06842105,6.254385965,104.2017544,2222.710526,19018,2294,1656,22968,1
538,49.82277778,6.0,115.8333333,1746.944444,15165,5758,1335,22258,0
539,18.76848837,4.860465116,67.02325581,1391.023256,13174,7517,1323,22014,1
540,19.45142857,3.571428571,61.0,1197.0,9972,10440,1573,21985,0
541,22.455,6.0,92.30769231,1466.307692,12542,7627,919,21088,0
542,22.12540909,5.5,75.09090909,1622.681818,11717,8312,1026,21055,0
543,25.3433871,5.193548387,95.09677419,1802.774194,12874,6663,1176,20713,0
544,31.195,6.0,105.875,1755.75,13628,6182,834,20644,0
545,31.30566667,6.259259259,96.92592593,1587.222222,15266,4275,933,20474,0
546,34.19,6.0,103.0,1794.0,12914,6438,1024,20376,0
547,33.70615385,6.153846154,120.1538462,1750.615385,13806,5597,883,20286,0
548,51.646,0.0,110.0,1995.0,13293,5594,1356,20243,0
549,23.35964286,5.25,81.28571429,1410.357143,9308,10218,675,20201,0
550,32.09,4.0,98.2,1754.4,10578,7669,1030,19277,0
551,46.5274,7.04,131.6,1596.92,15878,2408,982,19268,0
552,50.94,6.266666667,138.2833333,1986.766667,15426,2431,1042,18899,1
553,20.36464286,5.857142857,82.25,1534.392857,12611,5299,894,18804,1
554,20.6695,4.75,88.0,1586.0,9604,7855,1066,18525,0
555,94.098125,8.0,190.0,2967.0,12911,4618,827,18356,1
556,29.88478947,4.736842105,109.1052632,2238.631579,10101,7028,1104,18233,0
557,115.533,8.0,250.0,2998.0,15505,1603,1085,18193,0
558,32.898125,5.333333333,116.2916667,2081.375,13832,3145,855,17832,0
559,40.98307692,7.307692308,114.2692308,1352.576923,11275,5762,645,17682,0
560,12.49833333,5.0,48.66666667,1336.666667,6133,10551,966,17650,0
561,23.01661538,4.730769231,90.88461538,1709.538462,13101,3821,597,17519,0
562,11.370625,5.0,48.0,1518.0,10481,5983,892,17356,0
563,18.513,4.6,76.0,1599.0,9969,6556,767,17292,0
564,135.1055,6.5,309.0,3999.0,14972,1474,680,17126,0
565,43.08,4.666666667,105.0,2239.666667,11396,4368,1229,16993,0
566,23.0525,5.0,55.0,1406.0,7561,7991,1251,16803,0
567,25.17006452,5.516129032,79.30645161,1523.741935,11576,4299,881,16756,1
568,11.389,4.142857143,53.0,1308.285714,6981,8701,955,16637,0
569,39.7374,4.6,115.0,2234.4,9912,5643,1023,16578,0
570,42.2862,6.0,113.8,1740.0,6484,8647,1272,16403,0
571,39.725,6.8,110.0,1592.0,13837,1936,614,16387,0
572,14.94,5.2,59.6,958.6,5786,9862,592,16240,0
573,106.5488889,8.0,210.0,2976.333333,11314,3906,880,16100,1
574,52.19640625,5.3125,126.5,2323.9375,10304,4787,913,16004,0
575,264.675,7.0,420.0,6208.0,11682,3095,875,15652,0
576,22.69,4.8,82.2,1773.7,10991,3765,755,15511,0
577,37.52210345,3.896551724,107.3793103,2084.37931,11166,3313,920,15399,0
578,64.50769231,6.846153846,144.2307692,2048.538462,9404,5094,751,15249,1
579,17.31777778,3.666666667,58.44444444,1152.888889,5880,7690,1144,14714,0
580,17.44569231,4.692307692,68.26923077,1791.230769,10578,3308,821,14707,0
581,37.01736842,4.736842105,97.57894737,2697.368421,10495,3512,668,14675,1
582,7.92,4.0,33.33333333,868.3333333,8465,5480,613,14558,0
583,41.59161538,6.461538462,111.3076923,1624.769231,9185,4810,539,14534,0
584,42.74666667,5.0,128.5,2548.833333,11854,1723,471,14048,0
585,14.22409091,4.727272727,64.45454545,1353.363636,6213,6957,771,13941,0
586,51.44133333,7.2,123.9333333,1863.133333,7669,5280,919,13868,1
587,23.16515789,3.947368421,82.15789474,1817.315789,7999,5097,749,13845,0
588,38.9,5.84,113.84,1926.0,8559,4776,357,13692,1
589,30.99,0.0,105.0,335.0,10530,2647,472,13649,0
590,14.333375,4.5625,59.875,1183.25,5446,7403,749,13598,0
591,26.0,5.0,70.0,1597.0,2120,10321,896,13337,0
592,33.12857143,5.285714286,103.0,1914.714286,7187,5240,764,13191,0
593,20.9225,5.375,68.875,1272.4375,7741,4768,660,13169,0
594,13.70454545,4.818181818,47.45454545,1384.0,5074,7294,652,13020,0
595,18.76285714,4.714285714,80.42857143,1612.928571,8265,4018,656,12939,0
596,58.46907407,6.444444444,148.5185185,2174.037037,9249,2776,870,12895,1
597,30.351,6.3,83.5,1452.3,8430,3620,522,12572,0
598,18.615,5.2,69.6,1330.4,6007,5886,603,12496,0
599,158.976,8.0,326.0,3295.0,8810,3017,633,12460,0
600,9.465666667,4.666666667,50.0,996.0,4471,7286,543,12300,0
601,108.7471951,7.853658537,207.6097561,2304.97561,9333,2222,667,12222,1
602,32.723,3.6,96.0,1498.0,6703,4733,777,12213,0
603,25.2075,5.0,80.5,1753.0,6996,4370,746,12112,0
604,37.44666667,2.611111111,120.3333333,2085.055556,7870,3594,563,12027,0
605,17.065625,5.125,51.375,999.0,4380,7185,424,11989,0
606,13.11525,4.75,50.875,1430.75,7405,3886,542,11833,0
607,114.8758333,8.0,235.0,2979.0,9618,1579,580,11777,0
608,13.1466,4.8,55.4,1144.8,5000,6007,722,11729,0
609,13.24516667,4.833333333,66.66666667,1506.5,6017,4842,735,11594,0
610,42.5595,6.166666667,131.6666667,2313.666667,5585,5282,655,11522,0
611,26.19775,4.625,77.0,1495.0,5239,5534,646,11419,0
612,37.00904545,4.590909091,114.6818182,2208.090909,7787,2614,767,11168,0
613,36.38445588,4.5,125.7058824,2294.764706,8700,1835,553,11088,0
614,13.2053,6.0,35.8,679.0,5040,5319,667,11026,0
615,20.7195,4.71875,81.375,1950.90625,7590,2328,584,10502,0
616,30.236875,4.5,110.0,2316.0,8088,1862,549,10499,0
617,11.395,5.0,52.5,1047.75,4035,5463,522,10020,0
618,24.84390244,4.756097561,84.92682927,1982.756098,7716,1750,525,9991,0
619,18.88233333,4.666666667,74.0,1523.333333,5584,3666,601,9851,0
620,116.545,8.0,230.0,2981.0,8506,747,534,9787,0
621,17.22277778,4.888888889,70.0,1615.333333,5613,3492,538,9643,0
622,171.1333333,6.0,375.0,5000.0,7853,981,428,9262,0
623,16.05676923,4.923076923,67.0,1703.153846,5829,2721,450,9000,0
624,22.84857143,6.523809524,73.23809524,1241.857143,3960,4711,313,8984,0
625,20.37,5.642857143,74.21428571,1324.357143,6369,2073,397,8839,0
626,23.58666667,5.25,81.16666667,1509.75,5079,3439,197,8715,0
627,60.9552,5.5,146.0,2588.6,6134,2133,317,8584,1
628,285.247,7.2,428.2,5577.8,7068,953,393,8414,0
629,45.59125,5.25,104.1666667,2027.833333,5148,2810,443,8401,0
630,45.76307692,5.307692308,109.0769231,2053.0,5155,2598,472,8225,1
631,62.39565385,4.384615385,135.5,2972.307692,6395,1366,398,8159,0
632,60.87,6.75,228.0,1984.0,6410,1368,321,8099,0
633,24.674,0.0,60.0,160.0,3170,4358,571,8099,0
634,33.495,0.0,81.0,285.0,4488,3282,261,8031,0
635,43.26150943,5.905660377,135.3773585,2276.0,6455,1004,379,7838,1
636,36.64326667,4.466666667,88.73333333,2284.133333,5825,1341,409,7575,0
637,55.62,6.0,145.75,2460.75,4738,2449,361,7548,0
638,70.31925,4.5,199.0,4123.5,6298,770,255,7323,0
639,14.7754,4.8,51.4,1428.4,3408,3372,455,7235,0
640,23.22409091,4.909090909,82.0,1938.0,4403,2312,397,7112,0
641,30.352,4.4,99.0,2117.6,4513,2215,377,7105,0
642,18.657,5.0,59.58333333,1407.333333,3140,3486,390,7016,0
643,55.4225,6.0,221.0,3498.0,5844,864,221,6929,0
644,55.25,6.0,177.0,1997.0,5128,1332,307,6767,0
645,145.6466667,6.0,283.0,5000.0,5486,894,308,6688,0
646,29.151,5.0,89.0,2526.5,4943,1416,294,6653,0
647,20.20388889,4.777777778,82.33333333,1775.777778,3835,2320,391,6546,0
648,32.11766667,4.666666667,115.3333333,2362.0,4707,1309,302,6318,0
649,11.74,5.0,63.0,1405.0,2725,3148,443,6316,0
650,84.60125,6.5,220.5,3071.0,4988,1007,320,6315,0
651,20.43008333,4.791666667,69.875,1773.0,4954,1107,245,6306,0
652,37.350625,5.375,121.0625,1972.8125,4980,1014,308,6302,0
653,24.612,0.0,72.0,1339.0,3903,1757,363,6023,0
654,27.4066,6.0,89.0,1552.0,3529,2172,130,5831,0
655,20.74,5.0,75.0,1695.0,3201,2306,311,5818,0
656,26.59125,4.125,108.625,1911.75,3594,1930,252,5776,0
657,95.29916667,6.333333333,253.6666667,3764.333333,4728,666,214,5608,0
658,53.62733333,0.0,122.6666667,2331.333333,3922,1276,386,5584,0
659,42.50666667,7.142857143,99.52380952,1294.142857,3308,1871,279,5458,0
660,22.047,3.6,73.0,1329.0,3117,1976,357,5450,0
661,53.792,6.0,134.3333333,1730.0,4700,506,234,5440,0
662,10.83275,5.0,45.0,1242.0,2884,2290,262,5436,0
663,19.895,4.8,94.0,1742.6,3362,1815,243,5420,0
664,33.40333333,0.0,110.0,1998.0,3243,1757,201,5201,0
665,25.29875,4.5,94.0,1998.0,3349,1431,397,5177,0
666,38.93888889,6.0,135.5555556,1642.333333,2592,2311,269,5172,0
667,18.2955625,4.875,70.25,1836.5,4386,555,118,5059,0
668,19.71783333,4.0,98.0,1995.0,3120,1618,318,5056,0
669,24.35,6.0,60.0,698.0,3098,1604,339,5041,0
670,27.09825,4.666666667,91.75,2247.333333,3886,911,225,5022,0
671,36.70125,4.875,91.75,2019.75,3386,1346,264,4996,0
672,125.49625,8.0,282.25,3344.75,3694,905,219,4818,0
673,360.755,6.0,410.0,5341.0,4020,337,182,4539,0
674,32.73833333,0.0,100.0,1798.0,2819,1242,430,4491,0
675,55.2,6.0,163.5,2696.5,3059,1131,263,4453,0
676,20.21333333,6.0,74.0,1329.0,1965,1928,302,4195,0
677,27.78966667,4.666666667,110.6666667,2050.333333,2917,979,198,4094,0
678,7.712,5.0,29.0,899.0,1961,1757,219,3937,0
679,28.803,4.8,111.2,2126.8,3048,710,162,3920,0
680,41.616,4.6,125.36,2336.52,3126,552,242,3920,0
681,23.16515789,3.947368421,82.15789474,1817.315789,2488,1094,249,3831,0
682,44.62833333,4.333333333,127.6666667,3100.333333,2917,814,90,3821,1
683,29.57028571,5.0,84.0,1997.142857,2667,964,186,3817,1
684,273.755,6.0,381.0,5935.0,3310,286,148,3744,0
685,48.09553571,5.107142857,117.7857143,2315.0,3058,458,208,3724,0
686,19.055,4.6,89.2,1827.8,2674,895,148,3717,0
687,16.4455,4.666666667,78.0,1741.0,2359,1069,195,3623,0
688,20.27896296,4.111111111,72.85185185,1832.888889,2328,1090,204,3622,0
689,21.105625,5.0,60.625,1039.5,2081,1373,155,3609,0
690,27.935,5.0,103.5,1833.0,2192,1120,291,3603,0
691,56.15916667,5.5,174.3333333,3199.0,2215,1168,182,3565,0
692,25.08266667,4.533333333,93.6,2127.333333,2807,605,146,3558,0
693,30.839,4.6,121.0,2378.0,2229,1075,210,3514,0
694,57.22905851,5.234042553,120.4255319,2309.340426,2664,629,210,3503,1
695,134.789,8.0,390.0,4395.0,3175,192,129,3496,0
696,20.31264706,5.352941176,63.29411765,1344.823529,1751,1498,209,3458,1
697,17.31241935,4.967741935,66.35483871,1655.741935,2292,963,172,3427,0
698,35.37645833,6.0,103.0833333,1968.0,2563,667,195,3425,1
699,33.8615625,5.375,116.25,1925.25,2819,485,103,3407,0
700,12.6825,5.0,45.0,999.0,1526,1698,136,3360,0
701,17.587,4.083333333,73.08333333,1363.5,2021,1132,162,3315,0
702,50.48413043,7.304347826,150.6086957,1969.0,2419,622,225,3266,1
703,31.7425,4.833333333,119.6666667,2116.0,2482,639,144,3265,0
704,88.77777778,7.0,190.0,3377.444444,2245,797,215,3257,0
705,28.17,5.583333333,103.0,1706.333333,2372,726,149,3247,0
706,54.2675,5.666666667,114.0,1998.0,2252,797,146,3195,1
707,20.1241875,4.875,79.875,1836.875,2299,689,160,3148,0
708,15.16166667,4.666666667,75.0,1594.0,2085,835,153,3073,0
709,46.85390244,7.707317073,125.0487805,1642.04878,2569,383,105,3057,1
710,121.77,6.666666667,316.3333333,3740.0,2700,246,109,3055,0
711,43.9745,4.5,98.0,2309.0,2037,839,171,3047,0
712,27.12333333,6.0,101.0,1497.0,1731,1053,169,2953,0
713,59.4905,5.0,137.5,2734.5,2569,273,111,2953,0
714,11.7129,4.0,69.0,1864.8,2598,278,66,2942,0
715,36.90769355,4.5,126.1451613,2344.0,2357,434,147,2938,0
716,22.95383333,5.0,67.33333333,1908.166667,1959,719,153,2831,0
717,21.91166667,4.666666667,88.0,1586.0,1375,1275,155,2805,0
718,30.0062,3.2,115.4666667,2245.6,2161,416,143,2720,0
719,53.10142857,6.0,163.7142857,2679.285714,2177,369,129,2675,0
720,105.465,8.0,257.5,2981.0,2189,322,126,2637,0
721,13.44125,5.0,54.5,1304.0,1624,883,119,2626,0
722,35.72526667,4.4,121.0,2287.6,1755,741,111,2607,0
723,87.12,8.0,190.0,2967.0,2233,235,90,2558,1
724,38.48247059,4.882352941,90.94117647,2953.588235,1975,408,106,2489,1
725,87.487,0.0,188.0,3498.0,1619,704,126,2449,0
726,76.71,0.0,336.0,0.0,1860,378,97,2335,0
727,35.34,5.0,118.0,1781.0,1980,237,97,2314,0
728,59.05425,6.75,144.375,2417.875,1604,545,152,2301,1
729,42.93428571,3.857142857,122.1428571,2308.285714,1489,714,92,2295,0
730,37.471875,5.5,114.5,2167.5,1689,499,95,2283,0
731,81.295,8.0,250.0,2998.0,1976,229,61,2266,0
732,47.881,5.111111111,141.4444444,3106.666667,1606,547,102,2255,1
733,78.47722222,0.888888889,224.7777778,3196.555556,1857,233,149,2239,0
734,40.7645,4.333333333,133.3333333,2634.222222,1672,369,115,2156,0
735,57.22905851,5.234042553,120.4255319,2309.340426,1609,397,149,2155,1
736,30.081,4.0,110.0,2254.0,1485,534,135,2154,0
737,18.84548718,4.076923077,87.07692308,2326.358974,1889,196,66,2151,0
738,16.695,5.0,54.0,1360.0,1314,708,86,2108,0
739,158.823,4.5,250.0,3228.0,1820,174,111,2105,0
740,22.49,5.0,80.0,1261.25,579,1404,116,2099,0
741,28.96891667,5.0,72.625,1707.125,1259,637,177,2073,0
742,107.6705126,8.277310924,196.3361345,2521.092437,1847,149,65,2061,1
743,13.382,2.5,48.0,1343.0,774,1108,126,2008,0
744,38.025,4.5,129.5,2614.0,1265,624,96,1985,0
745,23.8115,5.0,64.0,1298.0,552,1260,146,1958,0
746,11.745,5.0,51.0,998.0,884,951,113,1948,0
747,35.535,6.0,93.6,1647.4,1593,275,52,1920,1
748,21.65952381,5.761904762,90.85714286,1809.714286,1507,291,84,1882,1
749,226.3833333,6.5,368.6666667,4857.0,1671,116,78,1865,0
750,30.86290909,4.454545455,105.5454545,2458.909091,1517,224,76,1817,0
751,22.127,5.0,83.0,1721.5,964,717,99,1780,0
752,24.75629032,5.709677419,81.74193548,1735.580645,1166,473,87,1726,1
753,37.773,5.555555556,114.0,2184.0,1083,532,71,1686,1
754,32.4898913,5.304347826,113.2826087,2093.021739,903,675,88,1666,0
755,13.191,5.0,51.33333333,1431.333333,705,833,97,1635,0
756,46.60136364,6.0,110.0,2393.0,1312,221,64,1597,1
757,146.2746154,5.769230769,234.8461538,4089.923077,1399,117,73,1589,0
758,31.1275,5.75,105.25,1688.25,1104,416,42,1562,0
759,37.04635294,6.0,91.44117647,1773.823529,1247,245,64,1556,1
760,69.397,5.0,173.0,3358.666667,1272,164,85,1521,0
761,35.86943902,5.585365854,117.0243902,1980.634146,1262,177,54,1493,0
762,14.350125,4.875,59.5,1642.875,1074,338,56,1468,0
763,88.46428571,0.0,230.0,3456.0,887,462,82,1431,0
764,37.31220238,5.678571429,102.7261905,2118.940476,1211,132,83,1426,1
765,173.506625,8.0,329.0,3307.25,1193,148,41,1382,0
766,24.84,5.0,102.0,2244.0,1021,267,47,1335,0
767,175.835,7.0,433.5,4493.5,1179,101,48,1328,0
768,85.05325,6.5,242.0,3696.0,1093,182,49,1324,0
769,17.325,5.0,55.0,1360.0,752,502,52,1306,0
770,9.358333333,4.333333333,47.0,1324.0,667,568,66,1301,0
771,37.32636,4.76,101.12,2349.08,1043,204,52,1299,0
772,17.5296,4.6,78.4,1549.8,1120,148,31,1299,0
773,16.29053333,4.8,57.86666667,1645.133333,850,372,59,1281,0
774,22.91875,5.25,75.5,1288.5,747,504,19,1270,0
775,11.917,5.0,49.13333333,999.0,484,731,41,1256,0
776,16.67175,4.5,74.0,1541.5,745,434,68,1247,0
777,23.245,4.5,98.0,1998.0,926,237,64,1227,0
778,245.168,6.0,338.0,4691.0,1106,78,39,1223,0
779,14.4382,4.9,64.2,1891.7,939,252,24,1215,0
780,74.609,3.2,239.2,3640.2,1095,83,30,1208,0
781,646.605,6.0,450.0,5733.0,1059,90,48,1197,0
782,35.27,6.0,112.0714286,1574.428571,723,383,81,1187,0
783,57.59,5.428571429,121.0,1998.0,748,363,55,1166,1
784,34.33029412,5.588235294,105.0,1962.058824,825,277,45,1147,1
785,35.29583333,5.0,102.0,2129.0,712,330,77,1119,0
786,28.9602,4.4,100.8,1936.6,844,215,56,1115,0
787,177.5,6.0,419.0,3799.0,1026,40,48,1114,0
788,61.235,5.0,147.0,2144.0,997,68,44,1109,0
789,45.78386047,4.813953488,106.3023256,2768.511628,826,207,60,1093,1
790,27.9925,5.5,103.0,1591.0,581,445,28,1054,0
791,15.40377778,5.0,60.11111111,1593.111111,828,184,30,1042,0
792,18.16715385,4.692307692,70.30769231,1932.153846,736,232,44,1012,0
793,32.65836364,6.0,101.8181818,1424.727273,291,628,82,1001,0
794,30.61932203,5.966101695,94.03389831,1497.169492,771554,410082,54201,1235837,0
795,18.53214286,5.714285714,68.57142857,1166.142857,523545,596343,49604,1169492,0
796,31.24215385,6.164835165,89.46153846,1537.406593,460814,299999,46520,807333,0
797,22.1,5.615384615,75.57692308,1219.653846,251904,351104,30997,634005,0
798,47.84837037,6.444444444,126.1111111,1995.777778,400861,122120,29801,552782,0
799,20.03375,4.833333333,71.33333333,1631.5,192959,303023,29526,525508,0
800,18.1925,5.074074074,60.96296296,1408.055556,203850,289078,31498,524426,0
801,39.97375,1.75,130.25,1998.5,416063,84572,19464,520099,0
802,20.3776087,4.869565217,67.95652174,1279.695652,158671,276933,28179,463783,0
803,26.4498867,5.408866995,87.31034483,1623.793103,241474,186612,24716,452802,0
804,15.46,5.0,60.8,1196.0,108637,296651,22056,427344,0
805,29.942625,4.5,106.225,1480.575,245697,138803,21985,406485,0
806,20.7206,3.52,74.4,1397.8,118678,195134,24591,338403,0
807,22.36209302,4.88372093,72.58139535,1743.44186,169187,100514,12682,282383,0
808,27.46483636,4.872727273,86.45454545,1723.0,143057,119640,14984,277681,0
809,46.06451282,6.487179487,125.4358974,1835.846154,212911,49068,14824,276803,0
810,46.5274,7.04,131.6,1596.92,193345,65934,16685,275964,0
811,57.92693548,6.161290323,149.7096774,2283.112903,195215,58757,13541,267513,0
812,26.3525,0.0,80.0,1498.0,91010,115095,12627,218732,0
813,21.70216667,4.9,79.76666667,1536.0,85168,122300,10864,218332,0
814,36.21929825,6.473684211,94.33333333,1424.666667,120182,80441,12173,212796,0
815,27.23911864,3.033898305,91.61016949,1677.949153,117838,76170,13225,207233,0
816,19.00794118,5.205882353,66.97058824,1292.352941,95847,76676,9031,181554,0
817,43.86363077,5.292307692,105.1692308,2083.523077,111645,58609,9388,179642,1
818,37.31523077,4.323076923,103.6769231,1873.261538,131249,31606,10283,173138,0
819,93.71425,8.0,225.0,2979.0,134919,20836,8972,164727,0
820,22.78208333,4.916666667,81.66666667,1847.666667,97667,56509,9570,163746,0
821,22.90364865,5.405405405,75.64864865,1364.0,65032,84963,8118,158113,0
822,107.4521429,8.0,182.5714286,2425.428571,117155,31105,6596,154856,1
823,32.06304348,5.956521739,89.34782609,1472.826087,80964,58749,7666,147379,1
824,78.07322727,7.672727273,192.4,2598.818182,116331,21490,8989,146810,0
825,37.4265,6.2,104.2,1796.6,70694,62131,8401,141226,0
826,18.64264,4.84,67.0,1698.64,85650,47192,6780,139622,0
827,19.93814035,5.649122807,76.31578947,1205.192982,64843,64457,5320,134620,0
828,30.65053846,6.346153846,95.0,1136.692308,99544,23393,5426,128363,0
829,12.35588235,4.647058824,53.88235294,1366.294118,62018,59579,5886,127483,0
830,49.28583333,6.0,145.0,1963.666667,89011,30461,6983,126455,0
831,31.1045119,4.547619048,93.01190476,1699.119048,50107,66567,9342,126016,0
832,34.02059211,5.552631579,99.0,1920.026316,95919,23949,5692,125560,1
833,43.54851613,1.35483871,137.7741935,2261.193548,56794,55682,8139,120615,0
834,12.32981818,4.818181818,53.81818182,1367.272727,56946,55185,5252,117383,0
835,39.39984314,5.784313725,117.7058824,2151.647059,86843,18837,6411,112091,0
836,107.6705126,8.277310924,196.3361345,2521.092437,83312,20403,4561,108276,1
837,29.26025,5.95,90.625,1462.3625,63942,33331,4286,101559,0
838,65.56875,8.0,167.25,1998.0,81248,15011,4059,100318,0
839,16.20874359,4.461538462,63.56410256,1650.205128,68717,26047,3961,98725,0
840,28.60820513,4.756410256,92.82051282,2043.820513,76321,16819,4600,97740,0
841,53.78571429,6.0,124.8571429,1855.0,64089,27624,5130,96843,1
842,37.46857143,5.857142857,103.4285714,1718.571429,45052,42327,6057,93436,0
843,82.06090909,7.727272727,199.7272727,2790.454545,74860,13452,5039,93351,1
844,19.37890909,4.863636364,61.27272727,1470.909091,48849,37911,3856,90616,0
845,42.66935185,5.907407407,118.1851852,2095.185185,66897,16236,3945,87078,0
846,32.93965169,6.348314607,114.8202247,1615.370787,57322,25831,3137,86290,0
847,26.51269565,4.02173913,93.58695652,1933.021739,62306,17348,4705,84359,0
848,11.14333333,5.0,50.0,998.0,24703,53336,4001,82040,0
849,16.59192308,5.0,52.84615385,998.0,29678,48990,2829,81497,0
850,50.96109091,6.181818182,135.2909091,1971.163636,61857,14866,4727,81450,1
851,30.99513158,5.789473684,101.8947368,1905.631579,45825,28920,3748,78493,0
852,19.08518182,3.727272727,68.90909091,1180.545455,30795,42104,5540,78439,0
853,64.59222222,6.777777778,178.5555556,2011.555556,40801,32563,5015,78379,0
854,15.20916667,5.0,53.0,998.0,24699,47185,5645,77529,0
855,26.29166667,5.6,74.73333333,1186.333333,19846,52629,4748,77223,1
856,19.31857143,5.0,66.42857143,1348.285714,40597,29959,3632,74188,1
857,39.35238095,5.0,98.04761905,1928.714286,59476,10529,3113,73118,0
858,34.93603125,5.25,97.71875,1820.65625,40207,27929,4145,72281,1
859,10.42388889,5.0,52.44444444,1095.777778,30013,35967,3702,69682,0
860,26.803,5.428571429,85.71428571,1310.0,38151,26197,4091,68439,0
861,13.48615385,5.0,52.38461538,1028.923077,24156,41092,2973,68221,0
862,21.6,6.0,64.625,1496.0,24699,39688,3493,67880,0
863,33.25025,6.166666667,112.75,1475.0,15533,46960,4513,67006,0
864,35.28132353,5.176470588,113.3529412,2106.5,47236,15269,3729,66234,0
865,32.33086957,5.891304348,103.1086957,1482.5,36477,25852,2736,65065,0
866,17.182,5.0,74.0,1994.0,38225,23756,2995,64976,0
867,16.011,5.0,51.77777778,998.0,25660,36381,2029,64070,0
868,72.79589474,6.210526316,166.3157895,3041.0,40410,17930,3806,62146,0
869,13.63642857,4.714285714,69.0,1424.857143,25686,32524,2668,60878,0
870,26.97346154,3.076923077,85.69230769,1515.282051,34755,21453,3278,59486,0
871,32.98557692,6.230769231,94.03846154,1528.807692,34787,20863,3835,59485,1
872,113.2693333,8.0,246.3333333,2994.666667,41172,13407,2997,57576,1
873,47.361875,3.75,113.375,1774.8125,40456,14365,2545,57366,1
874,38.72769231,5.538461538,114.6538462,2178.192308,42954,9189,2257,54400,1
875,15.14,5.0,64.0,1382.75,21146,29287,2284,52717,0
876,27.4386,6.34,85.28,1452.0,34090,14930,2510,51530,1
877,22.95871429,6.285714286,80.0,998.0,29006,20743,1654,51403,0
878,23.322,3.75,84.2,1853.9,35416,12066,2125,49607,0
879,17.03876744,5.302325581,73.48837209,1374.046512,21558,25240,2719,49517,0
880,77.41666667,7.0,188.3333333,2876.0,32941,13637,2863,49441,1
881,66.58842105,5.736842105,172.3157895,2934.631579,40998,5719,2146,48863,0
882,61.86283333,6.833333333,184.1666667,2748.333333,20611,23594,3432,47637,0
883,34.9090566,5.603773585,104.2264151,1805.924528,37520,7462,1998,46980,1
884,35.81481651,6.293577982,117.4311927,1921.46789,31231,12063,2658,45952,0
885,9.5628,4.6,50.0,996.0,16313,22562,3299,42174,0
886,25.39952941,4.647058824,78.85294118,1891.588235,30549,9540,2067,42156,0
887,30.5976,1.8,97.6,1757.6,32656,7318,1635,41609,0
888,32.1815,6.0,99.0,1448.6,25178,14074,1483,40735,0
889,17.34364706,4.745098039,70.92156863,1683.607843,23762,14506,2439,40707,0
890,31.5255,5.166666667,109.6666667,1861.833333,27727,10614,2134,40475,0
891,52.95719388,5.653061224,146.122449,2031.469388,31594,6590,2231,40415,0
892,21.02333333,5.0,92.33333333,1729.333333,24474,13756,1640,39870,0
893,137.5695455,8.0,223.5454545,2813.0,33810,3061,1632,38503,0
894,30.3775,6.3125,94.0625,935.625,14169,21583,2395,38147,0
895,47.52333333,6.0,128.8888889,1886.555556,23113,12803,1585,37501,1
896,26.97522727,5.863636364,88.09090909,1460.795455,23853,12446,1083,37382,0
897,36.52419118,5.176470588,113.3529412,2106.5,24938,9807,2083,36828,0
898,14.293,4.6,75.4,1479.0,20648,13724,1934,36306,0
899,45.6995,6.0,114.0,1854.2,24824,8493,2875,36192,1
900,33.798,0.0,96.0,1797.4,22542,9075,3495,35112,0
901,85.82946154,8.0,213.1538462,1969.0,22046,10610,2368,35024,0
902,22.77681818,5.272727273,92.36363636,1837.363636,20372,12101,1720,34193,0
903,39.70773684,4.842105263,117.5789474,2719.842105,21536,10653,1858,34047,1
904,158.7922667,7.466666667,293.5333333,3005.4,28724,3323,1565,33612,0
905,43.97,6.6,115.3,1634.2,20812,10846,1097,32755,1
906,28.60918919,5.945945946,100.5945946,1387.621622,20293,11217,1109,32619,0
907,52.085,8.0,223.8333333,1969.0,25697,4891,1737,32325,0
908,21.847,6.090909091,70.72727273,1052.272727,15780,14284,972,31036,0
909,9.8628,5.0,50.0,1090.4,14245,14032,2009,30286,0
910,78.74625,8.0,176.25,1997.0,26154,2735,1115,30004,1
911,17.82333333,4.666666667,70.33333333,1298.666667,13707,14348,1584,29639,0
912,76.5922,8.0,184.0,2396.4,16516,11059,1792,29367,0
913,44.14181818,6.545454545,144.6363636,2242.636364,19758,8239,1188,29185,1
914,59.0,7.0,166.0,1798.0,19253,7808,1653,28714,0
915,25.94322222,4.777777778,67.0,1372.666667,13098,13453,2010,28561,0
916,9.492272727,4.909090909,40.81818182,850.2727273,9861,17040,1558,28459,0
917,19.9680625,2.8125,55.375,592.5625,13528,13142,1480,28150,0
918,8.17,5.0,40.0,1108.0,10241,15703,1557,27501,0
919,41.38957143,7.285714286,105.7142857,1545.428571,13983,11635,1490,27108,1
920,38.7525,0.0,165.0,2488.0,16491,9735,752,26978,0
921,83.50125,6.5,213.5,3071.0,18892,6226,1595,26713,0
922,64.109625,6.75,202.125,2778.0,16906,7843,1670,26419,0
923,36.01325,6.0,151.6666667,2048.666667,18492,6674,735,25901,0
924,59.43242424,7.0,150.4545455,1981.818182,19035,4730,1115,24880,0
925,13.88308333,4.75,47.75,1373.75,8621,14725,1434,24780,0
926,43.06842105,6.254385965,104.2017544,2222.710526,19215,2295,1707,23217,1
927,22.455,6.0,92.30769231,1466.307692,13667,8379,1002,23048,0
928,11.370625,5.0,48.0,1518.0,13698,7826,1135,22659,0
929,49.82277778,6.0,115.8333333,1746.944444,15362,5834,1346,22542,0
930,25.3433871,5.193548387,95.09677419,1802.774194,13797,7426,1297,22520,0
931,19.45142857,3.571428571,61.0,1197.0,10219,10646,1635,22500,0
932,34.19,6.0,103.0,1794.0,14042,7192,1164,22398,0
933,27.13,5.768421053,96.05263158,1774.778947,12941,8486,807,22234,1
934,32.898125,5.333333333,116.2916667,2081.375,17099,3916,1101,22116,0
935,18.76848837,4.860465116,67.02325581,1391.023256,13007,7452,1292,21751,1
936,44.30857143,6.714285714,108.0,1663.928571,12313,8137,1015,21465,0
937,32.4898913,5.304347826,113.2826087,2093.021739,11417,8309,1166,20892,0
938,51.646,0.0,110.0,1995.0,13535,5724,1356,20615,0
939,31.195,6.0,105.875,1755.75,13687,6124,789,20600,0
940,32.09,4.0,98.2,1754.4,10703,8600,1109,20412,0
941,17.44569231,4.692307692,68.26923077,1791.230769,14492,4511,1139,20142,0
942,50.94,6.266666667,138.2833333,1986.766667,16154,2562,1106,19822,1
943,28.23090909,6.454545455,86.0,999.0,8413,8943,2187,19543,0
944,115.533,8.0,250.0,2998.0,16520,1676,1097,19293,0
945,22.12540909,5.5,75.09090909,1622.681818,10718,7503,959,19180,0
946,29.88478947,4.736842105,109.1052632,2238.631579,10649,7382,1138,19169,0
947,43.08,4.666666667,105.0,2239.666667,12854,4924,1372,19150,0
948,31.30566667,6.259259259,96.92592593,1587.222222,14187,3957,828,18972,0
949,22.69,4.8,82.2,1773.7,13285,4561,935,18781,0
950,46.5274,7.04,131.6,1596.92,15372,2321,933,18626,0
951,11.389,4.142857143,53.0,1308.285714,7677,9802,1065,18544,0
952,23.01661538,4.730769231,90.88461538,1709.538462,13373,3832,585,17790,0
953,20.36464286,5.857142857,82.25,1534.392857,11844,5065,842,17751,1
954,18.513,4.6,76.0,1599.0,10311,6643,743,17697,0
955,135.1055,6.5,309.0,3999.0,15097,1537,717,17351,0
956,12.49833333,5.0,48.66666667,1336.666667,6090,10314,917,17321,0
957,39.7374,4.6,115.0,2234.4,9996,6068,1128,17192,0
958,94.098125,8.0,190.0,2967.0,12072,4348,768,17188,1
959,23.0525,5.0,55.0,1406.0,7604,8291,1252,17147,0
960,37.52210345,3.896551724,107.3793103,2084.37931,12113,3636,1011,16760,0
961,37.01736842,4.736842105,97.57894737,2697.368421,11789,4084,763,16636,1
962,20.6695,4.75,88.0,1586.0,8655,6943,970,16568,0
963,25.17006452,5.516129032,79.30645161,1523.741935,11360,4124,809,16293,1
964,52.19640625,5.3125,126.5,2323.9375,10445,4803,903,16151,0
965,264.675,7.0,420.0,6208.0,11599,3217,904,15720,0
966,33.70615385,6.153846154,120.1538462,1750.615385,10668,4310,689,15667,0
967,13.24516667,4.833333333,66.66666667,1506.5,8007,6572,987,15566,0
968,42.2862,6.0,113.8,1740.0,6117,8227,1190,15534,0
969,7.92,4.0,33.33333333,868.3333333,8759,6112,654,15525,0
970,13.11525,4.75,50.875,1430.75,9467,5230,712,15409,0
971,42.74666667,5.0,128.5,2548.833333,12842,1978,505,15325,0
972,30.99,0.0,105.0,335.0,11639,3052,529,15220,0
973,14.94,5.2,59.6,958.6,5560,8784,525,14869,0
974,17.22277778,4.888888889,70.0,1615.333333,8497,5432,833,14762,0
975,27.08277108,6.228915663,86.63855422,1377.566265,6153,8058,504,14715,0
976,23.16515789,3.947368421,82.15789474,1817.315789,8494,5400,762,14656,0
977,41.59161538,6.461538462,111.3076923,1624.769231,9276,4781,536,14593,0
978,24.84390244,4.756097561,84.92682927,1982.756098,11176,2626,727,14529,0
979,37.00904545,4.590909091,114.6818182,2208.090909,10029,3396,997,14422,0
980,36.38445588,4.5,125.7058824,2294.764706,11212,2397,706,14315,0
981,14.22409091,4.727272727,64.45454545,1353.363636,6368,7014,741,14123,0
982,14.333375,4.5625,59.875,1183.25,5741,7569,766,14076,0
983,106.5488889,8.0,210.0,2976.333333,9867,3350,767,13984,1
984,13.70454545,4.818181818,47.45454545,1384.0,5212,7991,673,13876,0
985,26.0,5.0,70.0,1597.0,2064,10775,854,13693,0
986,20.7195,4.71875,81.375,1950.90625,9879,2979,747,13605,0
987,25.2075,5.0,80.5,1753.0,7732,4962,890,13584,0
988,39.725,6.8,110.0,1592.0,11415,1598,503,13516,0
989,16.05676923,4.923076923,67.0,1703.153846,8469,3903,656,13028,0
990,32.723,3.6,96.0,1498.0,6944,5204,781,12929,0
991,33.12857143,5.285714286,103.0,1914.714286,7025,5148,749,12922,0
992,30.236875,4.5,110.0,2316.0,9881,2283,652,12816,0
993,17.31777778,3.666666667,58.44444444,1152.888889,5053,6444,945,12442,0
994,18.76285714,4.714285714,80.42857143,1612.928571,7931,3742,593,12266,0
995,108.7471951,7.853658537,207.6097561,2304.97561,9255,2232,644,12131,1
996,26.19775,4.625,77.0,1495.0,5549,5868,650,12067,0
997,58.46907407,6.444444444,148.5185185,2174.037037,8322,2501,760,11583,1
998,13.2053,6.0,35.8,679.0,5033,5513,718,11264,0
999,64.50769231,6.846153846,144.2307692,2048.538462,6893,3798,569,11260,1
1000,23.35964286,5.25,81.28571429,1410.357143,5514,5117,337,10968,0
1001,42.5595,6.166666667,131.6666667,2313.666667,5313,5075,576,10964,0
1002,158.976,8.0,326.0,3295.0,7651,2664,579,10894,0
1003,20.9225,5.375,68.875,1272.4375,6352,3812,525,10689,0
1004,114.8758333,8.0,235.0,2979.0,8577,1471,509,10557,0
1005,37.44666667,2.611111111,120.3333333,2085.055556,6877,3176,486,10539,0
1006,18.615,5.2,69.6,1330.4,5039,4844,475,10358,0
1007,51.44133333,7.2,123.9333333,1863.133333,5866,3726,672,10264,1
1008,9.465666667,4.666666667,50.0,996.0,3826,5997,430,10253,0
1009,18.88233333,4.666666667,74.0,1523.333333,5907,3721,620,10248,0
1010,40.98307692,7.307692308,114.2692308,1352.576923,6584,3245,367,10196,0
1011,20.37,5.642857143,74.21428571,1324.357143,7220,2250,447,9917,0
1012,116.545,8.0,230.0,2981.0,8240,714,524,9478,0
1013,20.43008333,4.791666667,69.875,1773.0,7292,1640,364,9296,0
1014,36.64326667,4.466666667,88.73333333,2284.133333,7102,1655,498,9255,0
1015,62.39565385,4.384615385,135.5,2972.307692,7137,1564,495,9196,0
1016,171.1333333,6.0,375.0,5000.0,7616,921,426,8963,0
1017,45.59125,5.25,104.1666667,2027.833333,5418,2885,444,8747,0
1018,45.76307692,5.307692308,109.0769231,2053.0,5450,2685,492,8627,1
1019,24.674,0.0,60.0,160.0,3158,4431,563,8152,0
1020,29.151,5.0,89.0,2526.5,5963,1801,358,8122,0
1021,10.83275,5.0,45.0,1242.0,4230,3463,411,8104,0
1022,60.9552,5.5,146.0,2588.6,5750,1995,300,8045,1
1023,13.1466,4.8,55.4,1144.8,3488,3963,466,7917,0
1024,38.9,5.84,113.84,1926.0,5023,2638,199,7860,1
1025,14.7754,4.8,51.4,1428.4,3637,3714,477,7828,0
1026,32.11766667,4.666666667,115.3333333,2362.0,5803,1640,374,7817,0
1027,30.352,4.4,99.0,2117.6,4946,2439,423,7808,0
1028,285.247,7.2,428.2,5577.8,6557,858,372,7787,0
1029,23.22409091,4.909090909,82.0,1938.0,4770,2539,424,7733,0
1030,60.87,6.75,228.0,1984.0,6072,1261,295,7628,0
1031,30.351,6.3,83.5,1452.3,5122,2171,293,7586,0
1032,70.31925,4.5,199.0,4123.5,6356,767,236,7359,0
1033,18.657,5.0,59.58333333,1407.333333,3256,3482,392,7130,0
1034,55.25,6.0,177.0,1997.0,5213,1440,352,7005,0
1035,43.26150943,5.905660377,135.3773585,2276.0,5767,894,341,7002,1
1036,11.74,5.0,63.0,1405.0,2943,3524,506,6973,0
1037,55.4225,6.0,221.0,3498.0,5855,885,232,6972,0
1038,27.09825,4.666666667,91.75,2247.333333,5318,1234,284,6836,0
1039,20.20388889,4.777777778,82.33333333,1775.777778,3917,2319,392,6628,0
1040,19.71783333,4.0,98.0,1995.0,4005,2101,411,6517,0
1041,11.395,5.0,52.5,1047.75,2625,3300,379,6304,0
1042,18.2955625,4.875,70.25,1836.5,5411,703,152,6266,0
1043,55.62,6.0,145.75,2460.75,3901,2060,302,6263,0
1044,37.350625,5.375,121.0625,1972.8125,4845,1036,313,6194,0
1045,25.29875,4.5,94.0,1998.0,4024,1699,461,6184,0
1046,145.6466667,6.0,283.0,5000.0,4976,830,297,6103,0
1047,36.70125,4.875,91.75,2019.75,4139,1633,326,6098,0
1048,84.60125,6.5,220.5,3071.0,4815,979,291,6085,0
1049,20.74,5.0,75.0,1695.0,3293,2478,294,6065,0
1050,33.495,0.0,81.0,285.0,3452,2434,159,6045,0
1051,53.792,6.0,134.3333333,1730.0,5175,551,263,5989,0
1052,26.59125,4.125,108.625,1911.75,3712,1927,227,5866,0
1053,7.712,5.0,29.0,899.0,2851,2636,298,5785,0
1054,19.895,4.8,94.0,1742.6,3437,1840,240,5517,0
1055,53.62733333,0.0,122.6666667,2331.333333,3747,1167,361,5275,0
1056,23.58666667,5.25,81.16666667,1509.75,3089,2078,103,5270,0
1057,24.35,6.0,60.0,698.0,3132,1757,357,5246,0
1058,20.27896296,4.111111111,72.85185185,1832.888889,3411,1551,283,5245,0
1059,95.29916667,6.333333333,253.6666667,3764.333333,4408,631,204,5243,0
1060,41.616,4.6,125.36,2336.52,4137,783,312,5232,0
1061,16.4455,4.666666667,78.0,1741.0,3397,1531,276,5204,0
1062,27.78966667,4.666666667,110.6666667,2050.333333,3691,1233,233,5157,0
1063,23.16515789,3.947368421,82.15789474,1817.315789,3208,1449,316,4973,0
1064,20.1241875,4.875,79.875,1836.875,3492,1083,247,4822,0
1065,24.612,0.0,72.0,1339.0,3141,1365,290,4796,0
1066,29.57028571,5.0,84.0,1997.142857,3243,1231,241,4715,1
1067,55.2,6.0,163.5,2696.5,3124,1183,289,4596,0
1068,25.08266667,4.533333333,93.6,2127.333333,3631,763,183,4577,0
1069,17.587,4.083333333,73.08333333,1363.5,2715,1478,245,4438,0
1070,17.31241935,4.967741935,66.35483871,1655.741935,2891,1246,201,4338,0
1071,48.09553571,5.107142857,117.7857143,2315.0,3554,522,236,4312,0
1072,360.755,6.0,410.0,5341.0,3774,318,159,4251,0
1073,19.055,4.6,89.2,1827.8,3019,1029,177,4225,0
1074,28.803,4.8,111.2,2126.8,3264,746,150,4160,0
1075,15.16166667,4.666666667,75.0,1594.0,2644,1166,226,4036,0
1076,22.95383333,5.0,67.33333333,1908.166667,2763,1024,225,4012,0
1077,44.62833333,4.333333333,127.6666667,3100.333333,2950,823,83,3856,1
1078,31.7425,4.833333333,119.6666667,2116.0,2899,704,176,3779,0
1079,125.49625,8.0,282.25,3344.75,2948,649,172,3769,0
1080,27.935,5.0,103.5,1833.0,2294,1161,276,3731,0
1081,273.755,6.0,381.0,5935.0,3279,268,131,3678,0
1082,56.15916667,5.5,174.3333333,3199.0,2241,1232,187,3660,0
1083,36.90769355,4.5,126.1451613,2344.0,2904,559,157,3620,0
1084,20.21333333,6.0,74.0,1329.0,1716,1613,265,3594,0
1085,42.50666667,7.142857143,99.52380952,1294.142857,2202,1193,175,3570,0
1086,20.31264706,5.352941176,63.29411765,1344.823529,1825,1535,203,3563,1
1087,30.839,4.6,121.0,2378.0,2251,1101,201,3553,0
1088,43.9745,4.5,98.0,2309.0,2368,936,193,3497,0
1089,38.93888889,6.0,135.5555556,1642.333333,1854,1452,165,3471,0
1090,33.40333333,0.0,110.0,1998.0,2172,1085,129,3386,0
1091,30.0062,3.2,115.4666667,2245.6,2676,514,177,3367,0
1092,59.4905,5.0,137.5,2734.5,2804,321,116,3241,0
1093,134.789,8.0,390.0,4395.0,2858,199,123,3180,0
1094,54.2675,5.666666667,114.0,1998.0,2263,775,142,3180,1
1095,57.22905851,5.234042553,120.4255319,2309.340426,2365,575,175,3115,1
1096,11.7129,4.0,69.0,1864.8,2693,298,70,3061,0
1097,121.77,6.666666667,316.3333333,3740.0,2671,259,125,3055,0
1098,35.37645833,6.0,103.0833333,1968.0,2213,565,161,2939,1
1099,27.4066,6.0,89.0,1552.0,1821,1038,55,2914,0
1100,88.77777778,7.0,190.0,3377.444444,1989,694,187,2870,0
1101,38.48247059,4.882352941,90.94117647,2953.588235,2286,456,117,2859,1
1102,76.71,0.0,336.0,0.0,2200,513,116,2829,0
1103,21.105625,5.0,60.625,1039.5,1637,1000,142,2779,0
1104,21.91166667,4.666666667,88.0,1586.0,1349,1277,142,2768,0
1105,22.047,3.6,73.0,1329.0,1546,1034,177,2757,0
1106,18.84548718,4.076923077,87.07692308,2326.358974,2367,281,74,2722,0
1107,40.7645,4.333333333,133.3333333,2634.222222,2104,451,148,2703,0
1108,30.86290909,4.454545455,105.5454545,2458.909091,2225,349,108,2682,0
1109,35.34,5.0,118.0,1781.0,2258,307,115,2680,0
1110,53.10142857,6.0,163.7142857,2679.285714,2071,396,126,2593,0
1111,81.295,8.0,250.0,2998.0,2235,269,79,2583,0
1112,30.081,4.0,110.0,2254.0,1741,638,171,2550,0
1113,87.487,0.0,188.0,3498.0,1625,775,114,2514,0
1114,22.127,5.0,83.0,1721.5,1272,1035,135,2442,0
1115,35.72526667,4.4,121.0,2287.6,1621,676,91,2388,0
1116,107.6705126,8.277310924,196.3361345,2521.092437,2123,172,76,2371,1
1117,57.22905851,5.234042553,120.4255319,2309.340426,1758,436,174,2368,1
1118,105.465,8.0,257.5,2981.0,1931,300,129,2360,0
1119,27.12333333,6.0,101.0,1497.0,1413,739,160,2312,0
1120,11.745,5.0,51.0,998.0,1043,1077,149,2269,0
1121,37.471875,5.5,114.5,2167.5,1650,495,92,2237,0
1122,47.881,5.111111111,141.4444444,3106.666667,1554,559,91,2204,1
1123,59.05425,6.75,144.375,2417.875,1542,516,137,2195,1
1124,13.44125,5.0,54.5,1304.0,1410,684,99,2193,0
1125,28.17,5.583333333,103.0,1706.333333,1617,448,103,2168,0
1126,42.93428571,3.857142857,122.1428571,2308.285714,1419,658,86,2163,0
1127,28.96891667,5.0,72.625,1707.125,1309,676,174,2159,0
1128,158.823,4.5,250.0,3228.0,1864,175,111,2150,0
1129,38.025,4.5,129.5,2614.0,1308,699,100,2107,0
1130,13.191,5.0,51.33333333,1431.333333,916,1051,124,2091,0
1131,13.382,2.5,48.0,1343.0,764,1182,135,2081,0
1132,33.8615625,5.375,116.25,1925.25,1755,263,60,2078,0
1133,23.8115,5.0,64.0,1298.0,540,1322,155,2017,0
1134,32.73833333,0.0,100.0,1798.0,1259,547,190,1996,0
1135,14.350125,4.875,59.5,1642.875,1422,474,80,1976,0
1136,16.29053333,4.8,57.86666667,1645.133333,1296,578,89,1963,0
1137,9.358333333,4.333333333,47.0,1324.0,993,863,100,1956,0
1138,78.47722222,0.888888889,224.7777778,3196.555556,1602,202,136,1940,0
1139,46.60136364,6.0,110.0,2393.0,1581,264,73,1918,1
1140,24.84,5.0,102.0,2244.0,1410,371,79,1860,0
1141,23.245,4.5,98.0,1998.0,1375,385,97,1857,0
1142,35.86943902,5.585365854,117.0243902,1980.634146,1528,227,63,1818,0
1143,226.3833333,6.5,368.6666667,4857.0,1559,116,76,1751,0
1144,16.67175,4.5,74.0,1541.5,1049,593,93,1735,0
1145,69.397,5.0,173.0,3358.666667,1433,198,96,1727,0
1146,21.65952381,5.761904762,90.85714286,1809.714286,1373,254,70,1697,1
1147,16.695,5.0,54.0,1360.0,1026,582,71,1679,0
1148,37.773,5.555555556,114.0,2184.0,1077,513,70,1660,1
1149,22.49,5.0,80.0,1261.25,470,1092,83,1645,0
1150,14.4382,4.9,64.2,1891.7,1248,349,36,1633,0
1151,37.32636,4.76,101.12,2349.08,1291,247,88,1626,0
1152,28.9602,4.4,100.8,1936.6,1150,275,83,1508,0
1153,146.2746154,5.769230769,234.8461538,4089.923077,1309,112,78,1499,0
1154,17.5296,4.6,78.4,1549.8,1273,166,41,1480,0
1155,50.48413043,7.304347826,150.6086957,1969.0,1091,257,116,1464,1
1156,88.46428571,0.0,230.0,3456.0,914,450,86,1450,0
1157,18.16715385,4.692307692,70.30769231,1932.153846,1027,325,68,1420,0
1158,175.835,7.0,433.5,4493.5,1215,109,59,1383,0
1159,15.40377778,5.0,60.11111111,1593.111111,1044,263,34,1341,0
1160,12.47666667,4.666666667,58.66666667,1498.0,802,475,59,1336,0
1161,14.76166667,4.666666667,75.0,1594.0,838,428,67,1333,0
1162,37.04635294,6.0,91.44117647,1773.823529,1069,199,56,1324,1
1163,45.78386047,4.813953488,106.3023256,2768.511628,953,264,58,1275,1
1164,87.12,8.0,190.0,2967.0,1120,109,39,1268,1
1165,35.29583333,5.0,102.0,2129.0,800,372,88,1260,0
1166,646.605,6.0,450.0,5733.0,1083,103,55,1241,0
1167,35.27,6.0,112.0714286,1574.428571,749,404,85,1238,0
1168,20.49710714,4.142857143,72.42857143,1824.428571,830,336,67,1233,0
1169,24.75629032,5.709677419,81.74193548,1735.580645,821,353,55,1229,1
1170,74.609,3.2,239.2,3640.2,1101,92,27,1220,0
1171,37.31220238,5.678571429,102.7261905,2118.940476,1035,117,57,1209,1
1172,43.89111111,5.666666667,130.5555556,2457.555556,1042,112,54,1208,0
1173,34.10357143,4.571428571,121.8571429,2555.285714,975,166,59,1200,0
1174,34.33029412,5.588235294,105.0,1962.058824,846,288,40,1174,1
1175,177.5,6.0,419.0,3799.0,1072,46,54,1172,0
1176,245.168,6.0,338.0,4691.0,1003,74,34,1111,0
1177,15.764,5.0,66.0,1497.0,572,471,63,1106,0
1178,85.05325,6.5,242.0,3696.0,908,155,40,1103,0
1179,61.235,5.0,147.0,2144.0,964,69,41,1074,0
1180,57.59,5.428571429,121.0,1998.0,698,319,57,1074,1
1181,260.287,6.0,360.0,4308.0,962,50,42,1054,0
1182,111.993,5.0,220.0,4988.0,921,84,47,1052,0
1183,17.325,5.0,55.0,1360.0,608,386,39,1033,0
1184,11.28285714,4.285714286,49.28571429,1337.714286,602,380,48,1030,0
1185,7.863333333,5.0,44.0,1289.0,685,281,38,1004,0
1186,30.61932203,5.966101695,94.03389831,1497.169492,737225,392711,50915,1180851,0
1187,18.53214286,5.714285714,68.57142857,1166.142857,520479,588993,48115,1157587,0
1188,31.24215385,6.164835165,89.46153846,1537.406593,451080,293772,45399,790251,0
1189,22.1,5.615384615,75.57692308,1219.653846,258405,363332,31372,653109,0
1190,39.97375,1.75,130.25,1998.5,447663,93119,20076,560858,0
1191,47.84837037,6.444444444,126.1111111,1995.777778,402366,126492,29650,558508,0
1192,20.03375,4.833333333,71.33333333,1631.5,195791,319509,30018,545318,0
1193,18.1925,5.074074074,60.96296296,1408.055556,199588,283138,31184,513910,0
1194,20.3776087,4.869565217,67.95652174,1279.695652,166609,287718,28921,483248,0
1195,26.4498867,5.408866995,87.31034483,1623.793103,255189,196491,25860,477540,0
1196,15.46,5.0,60.8,1196.0,110107,303703,22096,435906,0
1197,29.942625,4.5,106.225,1480.575,245788,140025,22042,407855,0
1198,20.7206,3.52,74.4,1397.8,112400,188095,23662,324157,0
1199,22.36209302,4.88372093,72.58139535,1743.44186,178716,104599,12710,296025,0
1200,27.46483636,4.872727273,86.45454545,1723.0,145149,120643,14603,280395,0
1201,46.06451282,6.487179487,125.4358974,1835.846154,209388,48243,14302,271933,0
1202,46.5274,7.04,131.6,1596.92,187583,64666,16256,268505,0
1203,57.92693548,6.161290323,149.7096774,2283.112903,191779,57446,13036,262261,0
1204,27.23911864,3.033898305,91.61016949,1677.949153,124092,80049,13792,217933,0
1205,26.3525,0.0,80.0,1498.0,83601,104954,11236,199791,0
1206,36.21929825,6.473684211,94.33333333,1424.666667,109473,72799,10912,193184,0
1207,21.70216667,4.9,79.76666667,1536.0,70694,102610,8859,182163,0
1208,22.78208333,4.916666667,81.66666667,1847.666667,106811,61382,9978,178171,0
1209,43.86363077,5.292307692,105.1692308,2083.523077,109602,58195,9004,176801,1
1210,37.31523077,4.323076923,103.6769231,1873.261538,133115,32101,10284,175500,0
1211,18.64264,4.84,67.0,1698.64,105854,59282,8217,173353,0
1212,19.00794118,5.205882353,66.97058824,1292.352941,90171,71835,8281,170287,0
1213,93.71425,8.0,225.0,2979.0,134875,20704,8674,164253,0
1214,107.4521429,8.0,182.5714286,2425.428571,121045,31796,6571,159412,1
1215,12.35588235,4.647058824,53.88235294,1366.294118,72818,73068,6968,152854,0
1216,16.20874359,4.461538462,63.56410256,1650.205128,102885,40342,6050,149277,0
1217,34.02059211,5.552631579,99.0,1920.026316,112052,28712,6612,147376,1
1218,22.90364865,5.405405405,75.64864865,1364.0,58454,78427,7248,144129,0
1219,78.07322727,7.672727273,192.4,2598.818182,113382,20452,8917,142751,0
1220,12.32981818,4.818181818,53.81818182,1367.272727,66679,66060,5991,138730,0
1221,32.06304348,5.956521739,89.34782609,1472.826087,75759,54110,6866,136735,1
1222,19.93814035,5.649122807,76.31578947,1205.192982,59964,59467,4987,124418,0
1223,49.28583333,6.0,145.0,1963.666667,87224,30036,6788,124048,0
1224,31.1045119,4.547619048,93.01190476,1699.119048,48876,65307,9013,123196,0
1225,28.60820513,4.756410256,92.82051282,2043.820513,94595,21015,5666,121276,0
1226,43.54851613,1.35483871,137.7741935,2261.193548,56199,56484,8043,120726,0
1227,39.39984314,5.784313725,117.7058824,2151.647059,93147,20095,6807,120049,0
1228,30.65053846,6.346153846,95.0,1136.692308,92589,21444,4995,119028,0
1229,37.4265,6.2,104.2,1796.6,58385,52439,6886,117710,0
1230,26.51269565,4.02173913,93.58695652,1933.021739,75307,20646,5525,101478,0
1231,53.78571429,6.0,124.8571429,1855.0,66138,28709,5053,99900,1
1232,65.56875,8.0,167.25,1998.0,80160,15165,3827,99152,0
1233,107.6705126,8.277310924,196.3361345,2521.092437,76869,17760,3997,98626,1
1234,37.46857143,5.857142857,103.4285714,1718.571429,43507,43531,5980,93018,0
1235,17.182,5.0,74.0,1994.0,54632,33763,4223,92618,0
1236,82.06090909,7.727272727,199.7272727,2790.454545,71715,12911,4838,89464,1
1237,19.37890909,4.863636364,61.27272727,1470.909091,46140,35137,3413,84690,0
1238,29.26025,5.95,90.625,1462.3625,53535,27174,3378,84087,0
1239,50.96109091,6.181818182,135.2909091,1971.163636,62377,14985,4814,82176,1
1240,42.66935185,5.907407407,118.1851852,2095.185185,62838,15278,3592,81708,0
1241,32.93965169,6.348314607,114.8202247,1615.370787,54188,23925,2934,81047,0
1242,39.35238095,5.0,98.04761905,1928.714286,64971,11473,3297,79741,0
1243,19.08518182,3.727272727,68.90909091,1180.545455,29724,39208,5496,74428,0
1244,26.803,5.428571429,85.71428571,1310.0,40356,27897,4334,72587,0
1245,64.59222222,6.777777778,178.5555556,2011.555556,37729,29705,4699,72133,0
1246,16.59192308,5.0,52.84615385,998.0,26278,42472,2365,71115,0
1247,30.99513158,5.789473684,101.8947368,1905.631579,41454,26172,3239,70865,0
1248,11.14333333,5.0,50.0,998.0,21409,45482,3276,70167,0
1249,35.28132353,5.176470588,113.3529412,2106.5,48759,15684,3851,68294,0
1250,33.25025,6.166666667,112.75,1475.0,15621,46146,4369,66136,0
1251,15.20916667,5.0,53.0,998.0,21005,39620,4978,65603,0
1252,10.42388889,5.0,52.44444444,1095.777778,27628,32745,3320,63693,0
1253,72.79589474,6.210526316,166.3157895,3041.0,40682,18331,3689,62702,0
1254,13.63642857,4.714285714,69.0,1424.857143,26246,32079,2488,60813,0
1255,19.31857143,5.0,66.42857143,1348.285714,32971,23794,2830,59595,1
1256,13.48615385,5.0,52.38461538,1028.923077,20790,34023,2414,57227,0
1257,21.6,6.0,64.625,1496.0,21425,32674,2773,56872,0
1258,47.361875,3.75,113.375,1774.8125,39672,14010,2334,56016,1
1259,34.93603125,5.25,97.71875,1820.65625,31138,21142,3493,55773,1
1260,23.322,3.75,84.2,1853.9,39627,13399,2284,55310,0
1261,113.2693333,8.0,246.3333333,2994.666667,39118,12814,2675,54607,1
1262,38.72769231,5.538461538,114.6538462,2178.192308,42130,8874,2027,53031,1
1263,26.29166667,5.6,74.73333333,1186.333333,14548,35197,3274,53019,1
1264,32.98557692,6.230769231,94.03846154,1528.807692,30870,18683,3361,52914,1
1265,15.14,5.0,64.0,1382.75,21012,29400,2110,52522,0
1266,35.81481651,6.293577982,117.4311927,1921.46789,34664,13555,2903,51122,0
1267,66.58842105,5.736842105,172.3157895,2934.631579,42433,5948,2146,50527,0
1268,26.97346154,3.076923077,85.69230769,1515.282051,29784,17862,2720,50366,0
1269,27.4386,6.34,85.28,1452.0,32756,14441,2351,49548,1
1270,32.33086957,5.891304348,103.1086957,1482.5,27899,19082,1890,48871,0
1271,17.03876744,5.302325581,73.48837209,1374.046512,21357,24460,2577,48394,0
1272,17.34364706,4.745098039,70.92156863,1683.607843,28270,17266,2811,48347,0
1273,34.9090566,5.603773585,104.2264151,1805.924528,38293,7651,1956,47900,1
1274,77.41666667,7.0,188.3333333,2876.0,31808,13327,2694,47829,1
1275,16.011,5.0,51.77777778,998.0,20002,26360,1279,47641,0
1276,30.5976,1.8,97.6,1757.6,35754,7947,1747,45448,0
1277,22.95871429,6.285714286,80.0,998.0,25875,18023,1502,45400,0
1278,61.86283333,6.833333333,184.1666667,2748.333333,19073,22839,3183,45095,0
1279,25.39952941,4.647058824,78.85294118,1891.588235,32068,10138,2182,44388,0
1280,31.5255,5.166666667,109.6666667,1861.833333,30073,11795,2258,44126,0
1281,14.293,4.6,75.4,1479.0,24543,16667,2223,43433,0
1282,52.95719388,5.653061224,146.122449,2031.469388,33535,6874,2312,42721,0
1283,21.02333333,5.0,92.33333333,1729.333333,25745,15077,1691,42513,0
1284,30.3775,6.3125,94.0625,935.625,15065,24629,2634,42328,0
1285,137.5695455,8.0,223.5454545,2813.0,35805,3206,1651,40662,0
1286,9.5628,4.6,50.0,996.0,15039,20161,3075,38275,0
1287,45.6995,6.0,114.0,1854.2,25438,8875,2791,37104,1
1288,22.77681818,5.272727273,92.36363636,1837.363636,21695,12912,1758,36365,0
1289,39.70773684,4.842105263,117.5789474,2719.842105,22194,10862,1828,34884,1
1290,158.7922667,7.466666667,293.5333333,3005.4,28375,3241,1514,33130,0
1291,59.0,7.0,166.0,1798.0,22018,8792,1826,32636,0
1292,52.085,8.0,223.8333333,1969.0,25769,4833,1617,32219,0
1293,85.82946154,8.0,213.1538462,1969.0,19865,9489,2143,31497,0
1294,9.8628,5.0,50.0,1090.4,14969,14380,2075,31424,0
1295,8.17,5.0,40.0,1108.0,11065,18077,1626,30768,0
1296,33.798,0.0,96.0,1797.4,19602,7984,3120,30706,0
1297,36.52419118,5.176470588,113.3529412,2106.5,20679,8047,1770,30496,0
1298,26.97522727,5.863636364,88.09090909,1460.795455,19115,9705,761,29581,0
1299,47.52333333,6.0,128.8888889,1886.555556,18424,9965,1170,29559,1
1300,11.370625,5.0,48.0,1518.0,17374,10020,1389,28783,0
1301,25.94322222,4.777777778,67.0,1372.666667,12893,13698,2073,28664,0
1302,17.44569231,4.692307692,68.26923077,1791.230769,20303,6076,1560,27939,0
1303,43.97,6.6,115.3,1634.2,17486,9405,947,27838,1
1304,17.82333333,4.666666667,70.33333333,1298.666667,12661,12947,1402,27010,0
1305,83.50125,6.5,213.5,3071.0,18974,6328,1524,26826,0
1306,9.492272727,4.909090909,40.81818182,850.2727273,9512,15747,1379,26638,0
1307,44.14181818,6.545454545,144.6363636,2242.636364,17822,7668,1014,26504,1
1308,32.898125,5.333333333,116.2916667,2081.375,20355,4845,1265,26465,0
1309,76.5922,8.0,184.0,2396.4,14173,10207,1476,25856,0
1310,13.88308333,4.75,47.75,1373.75,8452,15434,1500,25386,0
1311,22.455,6.0,92.30769231,1466.307692,14810,9333,1146,25289,0
1312,34.19,6.0,103.0,1794.0,15565,8267,1269,25101,0
1313,28.60918919,5.945945946,100.5945946,1387.621622,15561,8345,705,24611,0
1314,19.9680625,2.8125,55.375,592.5625,11952,11403,1190,24545,0
1315,36.01325,6.0,151.6666667,2048.666667,17517,6263,680,24460,0
1316,64.109625,6.75,202.125,2778.0,15321,7428,1531,24280,0
1317,32.1815,6.0,99.0,1448.6,15046,8051,790,23887,0
1318,25.3433871,5.193548387,95.09677419,1802.774194,14395,8051,1302,23748,0
1319,41.38957143,7.285714286,105.7142857,1545.428571,12357,10089,1256,23702,1
1320,43.06842105,6.254385965,104.2017544,2222.710526,19649,2309,1656,23614,1
1321,49.82277778,6.0,115.8333333,1746.944444,15519,5954,1322,22795,0
1322,19.45142857,3.571428571,61.0,1197.0,10268,10792,1680,22740,0
1323,22.69,4.8,82.2,1773.7,16002,5495,1124,22621,0
1324,78.74625,8.0,176.25,1997.0,19245,1999,809,22053,1
1325,21.847,6.090909091,70.72727273,1052.272727,11468,9926,606,22000,0
1326,32.09,4.0,98.2,1754.4,10831,9646,1237,21714,0
1327,17.22277778,4.888888889,70.0,1615.333333,12208,8022,1208,21438,0
1328,43.08,4.666666667,105.0,2239.666667,14272,5545,1549,21366,0
1329,27.13,5.768421053,96.05263158,1774.778947,12382,7899,694,20975,1
1330,115.533,8.0,250.0,2998.0,17913,1855,1157,20925,0
1331,18.76848837,4.860465116,67.02325581,1391.023256,12395,7204,1242,20841,1
1332,24.84390244,4.756097561,84.92682927,1982.756098,16106,3721,998,20825,0
1333,50.94,6.266666667,138.2833333,1986.766667,16836,2625,1116,20577,1
1334,51.646,0.0,110.0,1995.0,13535,5591,1361,20487,0
1335,13.11525,4.75,50.875,1430.75,12349,7146,944,20439,0
1336,13.24516667,4.833333333,66.66666667,1506.5,10393,8681,1300,20374,0
1337,11.389,4.142857143,53.0,1308.285714,8293,10861,1136,20290,0
1338,29.88478947,4.736842105,109.1052632,2238.631579,10998,7677,1113,19788,0
1339,38.7525,0.0,165.0,2488.0,12105,7029,515,19649,0
1340,31.195,6.0,105.875,1755.75,13020,5784,660,19464,0
1341,37.01736842,4.736842105,97.57894737,2697.368421,13381,4685,769,18835,1
1342,16.05676923,4.923076923,67.0,1703.153846,12064,5630,976,18670,0
1343,37.00904545,4.590909091,114.6818182,2208.090909,12888,4383,1191,18462,0
1344,36.38445588,4.5,125.7058824,2294.764706,14347,3165,895,18407,0
1345,37.52210345,3.896551724,107.3793103,2084.37931,13168,3958,1102,18228,0
1346,39.7374,4.6,115.0,2234.4,10199,6676,1163,18038,0
1347,18.513,4.6,76.0,1599.0,10553,6547,690,17790,0
1348,32.4898913,5.304347826,113.2826087,2093.021739,9719,7003,964,17686,0
1349,135.1055,6.5,309.0,3999.0,15292,1654,674,17620,0
1350,59.43242424,7.0,150.4545455,1981.818182,13583,3209,810,17602,0
1351,31.30566667,6.259259259,96.92592593,1587.222222,13068,3675,737,17480,0
1352,20.7195,4.71875,81.375,1950.90625,12679,3791,887,17357,0
1353,23.0525,5.0,55.0,1406.0,7570,8512,1247,17329,0
1354,23.01661538,4.730769231,90.88461538,1709.538462,12867,3656,556,17079,0
1355,7.92,4.0,33.33333333,868.3333333,9314,6960,754,17028,0
1356,46.5274,7.04,131.6,1596.92,14051,2138,820,17009,0
1357,30.99,0.0,105.0,335.0,12692,3403,554,16649,0
1358,20.36464286,5.857142857,82.25,1534.392857,11093,4817,739,16649,1
1359,42.74666667,5.0,128.5,2548.833333,13611,2094,504,16209,0
1360,22.12540909,5.5,75.09090909,1622.681818,9042,6341,796,16179,0
1361,52.19640625,5.3125,126.5,2323.9375,10411,4779,892,16082,0
1362,94.098125,8.0,190.0,2967.0,11052,4195,676,15923,1
1363,30.236875,4.5,110.0,2316.0,12224,2833,806,15863,0
1364,264.675,7.0,420.0,6208.0,11607,3327,890,15824,0
1365,25.17006452,5.516129032,79.30645161,1523.741935,10796,3801,701,15298,1
1366,23.16515789,3.947368421,82.15789474,1817.315789,8854,5564,779,15197,0
1367,44.30857143,6.714285714,108.0,1663.928571,8695,5716,746,15157,0
1368,41.59161538,6.461538462,111.3076923,1624.769231,9425,4817,481,14723,0
1369,13.70454545,4.818181818,47.45454545,1384.0,5256,8598,722,14576,0
1370,25.2075,5.0,80.5,1753.0,8229,5342,900,14471,0
1371,12.49833333,5.0,48.66666667,1336.666667,5239,8458,766,14463,0
1372,14.333375,4.5625,59.875,1183.25,6021,7640,732,14393,0
1373,20.6695,4.75,88.0,1586.0,7561,5698,852,14111,0
1374,14.22409091,4.727272727,64.45454545,1353.363636,6487,6819,686,13992,0
1375,26.0,5.0,70.0,1597.0,1878,11159,834,13871,0
1376,20.43008333,4.791666667,69.875,1773.0,10766,2464,527,13757,0
1377,32.723,3.6,96.0,1498.0,7280,5536,823,13639,0
1378,42.2862,6.0,113.8,1740.0,5355,7165,1039,13559,0
1379,26.19775,4.625,77.0,1495.0,5825,6143,637,12605,0
1380,33.12857143,5.285714286,103.0,1914.714286,6837,4947,708,12492,0
1381,10.83275,5.0,45.0,1242.0,6276,5225,597,12098,0
1382,33.70615385,6.153846154,120.1538462,1750.615385,8256,3196,516,11968,0
1383,14.94,5.2,59.6,958.6,4544,6961,418,11923,0
1384,106.5488889,8.0,210.0,2976.333333,8452,2838,618,11908,1
1385,108.7471951,7.853658537,207.6097561,2304.97561,9087,2178,630,11895,1
1386,39.725,6.8,110.0,1592.0,10071,1322,429,11822,0
1387,36.64326667,4.466666667,88.73333333,2284.133333,8950,2131,614,11695,0
1388,18.76285714,4.714285714,80.42857143,1612.928571,7451,3553,526,11530,0
1389,13.2053,6.0,35.8,679.0,4959,5696,728,11383,0
1390,20.37,5.642857143,74.21428571,1324.357143,8080,2411,474,10965,0
1391,62.39565385,4.384615385,135.5,2972.307692,8232,1800,575,10607,0
1392,18.88233333,4.666666667,74.0,1523.333333,6122,3816,616,10554,0
1393,58.46907407,6.444444444,148.5185185,2174.037037,7462,2229,663,10354,1
1394,17.31777778,3.666666667,58.44444444,1152.888889,4165,5138,819,10122,0
1395,114.8758333,8.0,235.0,2979.0,8186,1433,448,10067,0
1396,158.976,8.0,326.0,3295.0,7026,2487,503,10016,0
1397,29.151,5.0,89.0,2526.5,7175,2225,407,9807,0
1398,42.5595,6.166666667,131.6666667,2313.666667,4854,4415,456,9725,0
1399,27.09825,4.666666667,91.75,2247.333333,7334,1714,401,9449,0
1400,32.11766667,4.666666667,115.3333333,2362.0,6995,2007,419,9421,0
1401,37.44666667,2.611111111,120.3333333,2085.055556,5878,2673,422,8973,0
1402,116.545,8.0,230.0,2981.0,7833,659,457,8949,0
1403,45.59125,5.25,104.1666667,2027.833333,5454,2896,448,8798,0
1404,45.76307692,5.307692308,109.0769231,2053.0,5516,2751,492,8759,1
1405,20.9225,5.375,68.875,1272.4375,5196,3020,417,8633,0
1406,171.1333333,6.0,375.0,5000.0,7223,911,390,8524,0
1407,30.352,4.4,99.0,2117.6,5282,2667,409,8358,0
1408,14.7754,4.8,51.4,1428.4,3849,3955,505,8309,0
1409,23.22409091,4.909090909,82.0,1938.0,5031,2759,417,8207,0
1410,24.674,0.0,60.0,160.0,3243,4401,543,8187,0
1411,7.712,5.0,29.0,899.0,3931,3835,404,8170,0
1412,19.71783333,4.0,98.0,1995.0,5039,2560,518,8117,0
1413,18.2955625,4.875,70.25,1836.5,6957,945,198,8100,0
1414,20.27896296,4.111111111,72.85185185,1832.888889,5159,2309,406,7874,0
1415,9.465666667,4.666666667,50.0,996.0,2938,4434,321,7693,0
1416,11.74,5.0,63.0,1405.0,3154,3826,538,7518,0
1417,60.9552,5.5,146.0,2588.6,5387,1838,258,7483,1
1418,285.247,7.2,428.2,5577.8,6279,780,340,7399,0
1419,20.1241875,4.875,79.875,1836.875,5293,1702,358,7353,0
1420,55.25,6.0,177.0,1997.0,5431,1543,377,7351,0
1421,16.4455,4.666666667,78.0,1741.0,4720,2119,341,7180,0
1422,41.616,4.6,125.36,2336.52,5668,1105,401,7174,0
1423,18.615,5.2,69.6,1330.4,3608,3249,315,7172,0
1424,70.31925,4.5,199.0,4123.5,6218,724,204,7146,0
1425,36.70125,4.875,91.75,2019.75,4801,1912,377,7090,0
1426,18.657,5.0,59.58333333,1407.333333,3347,3367,373,7087,0
1427,60.87,6.75,228.0,1984.0,5579,1163,273,7015,0
1428,25.29875,4.5,94.0,1998.0,4566,1877,531,6974,0
1429,55.4225,6.0,221.0,3498.0,5707,930,245,6882,0
1430,64.50769231,6.846153846,144.2307692,2048.538462,4218,2284,373,6875,1
1431,53.792,6.0,134.3333333,1730.0,5696,626,286,6608,0
1432,27.78966667,4.666666667,110.6666667,2050.333333,4732,1497,301,6530,0
1433,23.16515789,3.947368421,82.15789474,1817.315789,4161,1879,435,6475,0
1434,13.1466,4.8,55.4,1144.8,2895,3045,402,6342,0
1435,20.74,5.0,75.0,1695.0,3349,2610,305,6264,0
1436,20.20388889,4.777777778,82.33333333,1775.777778,3577,2141,332,6050,0
1437,25.08266667,4.533333333,93.6,2127.333333,4739,985,228,5952,0
1438,37.350625,5.375,121.0625,1972.8125,4520,1000,281,5801,0
1439,17.587,4.083333333,73.08333333,1363.5,3528,1908,313,5749,0
1440,29.57028571,5.0,84.0,1997.142857,3930,1484,294,5708,1
1441,26.59125,4.125,108.625,1911.75,3615,1880,186,5681,0
1442,84.60125,6.5,220.5,3071.0,4409,905,283,5597,0
1443,19.895,4.8,94.0,1742.6,3526,1831,237,5594,0
1444,22.95383333,5.0,67.33333333,1908.166667,3790,1466,326,5582,0
1445,145.6466667,6.0,283.0,5000.0,4556,747,251,5554,0
1446,43.26150943,5.905660377,135.3773585,2276.0,4558,702,263,5523,1
1447,17.31241935,4.967741935,66.35483871,1655.741935,3581,1625,239,5445,0
1448,24.35,6.0,60.0,698.0,3186,1869,371,5426,0
1449,51.44133333,7.2,123.9333333,1863.133333,3059,1816,337,5212,1
1450,15.16166667,4.666666667,75.0,1594.0,3435,1517,250,5202,0
1451,40.98307692,7.307692308,114.2692308,1352.576923,3220,1555,167,4942,0
1452,48.09553571,5.107142857,117.7857143,2315.0,4084,585,256,4925,0
1453,95.29916667,6.333333333,253.6666667,3764.333333,4133,590,174,4897,0
1454,55.62,6.0,145.75,2460.75,2997,1614,238,4849,0
1455,53.62733333,0.0,122.6666667,2331.333333,3393,1057,335,4785,0
1456,19.055,4.6,89.2,1827.8,3343,1147,183,4673,0
1457,55.2,6.0,163.5,2696.5,3075,1223,289,4587,0
1458,31.7425,4.833333333,119.6666667,2116.0,3371,824,189,4384,0
1459,36.90769355,4.5,126.1451613,2344.0,3509,663,192,4364,0
1460,28.803,4.8,111.2,2126.8,3374,757,153,4284,0
1461,30.0062,3.2,115.4666667,2245.6,3359,658,235,4252,0
1462,33.495,0.0,81.0,285.0,2496,1670,81,4247,0
1463,23.35964286,5.25,81.28571429,1410.357143,2135,1955,133,4223,0
1464,30.86290909,4.454545455,105.5454545,2458.909091,3434,503,150,4087,0
1465,28.23090909,6.454545455,86.0,999.0,2016,1911,116,4043,0
1466,360.755,6.0,410.0,5341.0,3552,305,144,4001,0
1467,43.9745,4.5,98.0,2309.0,2615,1105,222,3942,0
1468,44.62833333,4.333333333,127.6666667,3100.333333,3002,825,82,3909,1
1469,27.935,5.0,103.5,1833.0,2345,1200,279,3824,0
1470,24.612,0.0,72.0,1339.0,2425,1009,228,3662,0
1471,56.15916667,5.5,174.3333333,3199.0,2219,1251,172,3642,0
1472,273.755,6.0,381.0,5935.0,3240,258,114,3612,0
1473,30.351,6.3,83.5,1452.3,2480,1005,126,3611,0
1474,20.31264706,5.352941176,63.29411765,1344.823529,1868,1529,199,3596,1
1475,18.84548718,4.076923077,87.07692308,2326.358974,3093,384,95,3572,0
1476,59.4905,5.0,137.5,2734.5,3079,366,124,3569,0
1477,30.839,4.6,121.0,2378.0,2167,1081,196,3444,0
1478,76.71,0.0,336.0,0.0,2658,607,124,3389,0
1479,40.7645,4.333333333,133.3333333,2634.222222,2611,565,183,3359,0
1480,22.127,5.0,83.0,1721.5,1823,1332,184,3339,0
1481,134.789,8.0,390.0,4395.0,3001,187,136,3324,0
1482,38.48247059,4.882352941,90.94117647,2953.588235,2648,523,150,3321,1
1483,11.7129,4.0,69.0,1864.8,2874,364,75,3313,0
1484,54.2675,5.666666667,114.0,1998.0,2265,784,143,3192,1
1485,35.34,5.0,118.0,1781.0,2682,370,122,3174,0
1486,16.29053333,4.8,57.86666667,1645.133333,2105,919,147,3171,0
1487,11.395,5.0,52.5,1047.75,1378,1551,212,3141,0
1488,38.9,5.84,113.84,1926.0,2043,1020,66,3129,1
1489,125.49625,8.0,282.25,3344.75,2489,504,132,3125,0
1490,81.295,8.0,250.0,2998.0,2678,342,87,3107,0
1491,121.77,6.666666667,316.3333333,3740.0,2668,276,121,3065,0
1492,30.081,4.0,110.0,2254.0,2012,741,210,2963,0
1493,9.358333333,4.333333333,47.0,1324.0,1465,1299,148,2912,0
1494,107.6705126,8.277310924,196.3361345,2521.092437,2540,227,78,2845,1
1495,23.245,4.5,98.0,1998.0,2103,563,145,2811,0
1496,21.91166667,4.666666667,88.0,1586.0,1409,1263,128,2800,0
1497,14.350125,4.875,59.5,1642.875,1967,688,112,2767,0
1498,13.191,5.0,51.33333333,1431.333333,1180,1376,154,2710,0
1499,57.22905851,5.234042553,120.4255319,2309.340426,2014,513,156,2683,1
1500,24.84,5.0,102.0,2244.0,2047,510,95,2652,0
1501,57.22905851,5.234042553,120.4255319,2309.340426,1946,498,185,2629,1
1502,11.745,5.0,51.0,998.0,1194,1228,169,2591,0
1503,20.21333333,6.0,74.0,1329.0,1272,1112,154,2538,0
1504,16.67175,4.5,74.0,1541.5,1563,835,122,2520,0
1505,88.77777778,7.0,190.0,3377.444444,1731,627,154,2512,0
1506,87.487,0.0,188.0,3498.0,1625,747,107,2479,0
1507,35.37645833,6.0,103.0833333,1968.0,1822,461,116,2399,1
1508,14.4382,4.9,64.2,1891.7,1842,487,61,2390,0
1509,53.10142857,6.0,163.7142857,2679.285714,1866,371,117,2354,0
1510,23.58666667,5.25,81.16666667,1509.75,1396,897,38,2331,0
1511,46.60136364,6.0,110.0,2393.0,1898,335,88,2321,1
1512,35.86943902,5.585365854,117.0243902,1980.634146,1948,284,86,2318,0
1513,158.823,4.5,250.0,3228.0,1914,180,122,2216,0
1514,28.96891667,5.0,72.625,1707.125,1329,707,165,2201,0
1515,38.025,4.5,129.5,2614.0,1369,725,105,2199,0
1516,37.32636,4.76,101.12,2349.08,1768,342,86,2196,0
1517,12.47666667,4.666666667,58.66666667,1498.0,1313,780,95,2188,0
1518,47.881,5.111111111,141.4444444,3106.666667,1527,532,78,2137,1
1519,13.382,2.5,48.0,1343.0,736,1252,140,2128,0
1520,37.471875,5.5,114.5,2167.5,1519,482,78,2079,0
1521,28.9602,4.4,100.8,1936.6,1593,379,103,2075,0
1522,23.8115,5.0,64.0,1298.0,551,1328,168,2047,0
1523,69.397,5.0,173.0,3358.666667,1674,224,111,2009,0
1524,42.93428571,3.857142857,122.1428571,2308.285714,1317,599,69,1985,0
1525,18.16715385,4.692307692,70.30769231,1932.153846,1450,434,88,1972,0
1526,59.05425,6.75,144.375,2417.875,1384,424,109,1917,1
1527,15.40377778,5.0,60.11111111,1593.111111,1500,365,35,1900,0
1528,14.76166667,4.666666667,75.0,1594.0,1179,621,85,1885,0
1529,20.49710714,4.142857143,72.42857143,1824.428571,1268,510,98,1876,0
1530,21.105625,5.0,60.625,1039.5,1101,649,93,1843,0
1531,13.44125,5.0,54.5,1304.0,1154,564,73,1791,0
1532,105.465,8.0,257.5,2981.0,1467,233,89,1789,0
1533,78.47722222,0.888888889,224.7777778,3196.555556,1468,176,112,1756,0
1534,35.72526667,4.4,121.0,2287.6,1198,482,56,1736,0
1535,42.50666667,7.142857143,99.52380952,1294.142857,1056,568,101,1725,0
1536,17.5296,4.6,78.4,1549.8,1432,187,53,1672,0
1537,34.10357143,4.571428571,121.8571429,2555.285714,1330,223,88,1641,0
1538,37.773,5.555555556,114.0,2184.0,1051,483,56,1590,1
1539,11.28285714,4.285714286,49.28571429,1337.714286,930,554,72,1556,0
1540,226.3833333,6.5,368.6666667,4857.0,1382,96,77,1555,0
1541,7.863333333,5.0,44.0,1289.0,1080,407,57,1544,0
1542,43.89111111,5.666666667,130.5555556,2457.555556,1288,154,67,1509,0
1543,88.46428571,0.0,230.0,3456.0,938,450,89,1477,0
1544,45.78386047,4.813953488,106.3023256,2768.511628,1105,299,67,1471,1
1545,21.65952381,5.761904762,90.85714286,1809.714286,1190,217,62,1469,1
1546,38.93888889,6.0,135.5555556,1642.333333,805,564,78,1447,0
1547,28.17,5.583333333,103.0,1706.333333,1067,290,69,1426,0
1548,146.2746154,5.769230769,234.8461538,4089.923077,1217,97,76,1390,0
1549,175.835,7.0,433.5,4493.5,1208,101,57,1366,0
1550,18.19842857,5.0,87.71428571,1696.428571,954,307,72,1333,0
1551,35.29583333,5.0,102.0,2129.0,847,395,82,1324,0
1552,15.764,5.0,66.0,1497.0,694,549,76,1319,0
1553,646.605,6.0,450.0,5733.0,1155,98,51,1304,0
1554,33.40333333,0.0,110.0,1998.0,842,391,59,1292,0
1555,30.92666667,4.666666667,110.3333333,2328.333333,928,278,72,1278,0
1556,35.27,6.0,112.0714286,1574.428571,752,414,87,1253,0
1557,16.695,5.0,54.0,1360.0,750,435,49,1234,0
1558,74.609,3.2,239.2,3640.2,1108,94,28,1230,0
1559,34.33029412,5.588235294,105.0,1962.058824,871,294,34,1199,1
1560,17.42714286,5.0,87.71428571,1696.428571,855,280,57,1192,0
1561,177.5,6.0,419.0,3799.0,1081,43,62,1186,0
1562,111.993,5.0,220.0,4988.0,1031,87,47,1165,0
1563,260.287,6.0,360.0,4308.0,1001,50,42,1093,0
1564,37.04635294,6.0,91.44117647,1773.823529,866,154,47,1067,1
1565,31.79107143,4.571428571,104.1428571,2211.071429,847,171,44,1062,0
1566,57.59,5.428571429,121.0,1998.0,701,298,46,1045,1
1567,12.924,4.0,43.0,989.0,484,475,72,1031,0
1568,27.12333333,6.0,101.0,1497.0,611,355,64,1030,0
1569,33.8615625,5.375,116.25,1925.25,872,124,28,1024,0
1570,110.0985,5.0,235.0,4957.0,923,54,43,1020,0
1571,38.79428571,4.428571429,98.57142857,2755.571429,819,166,34,1019,1
1572,37.31220238,5.678571429,102.7261905,2118.940476,877,90,44,1011,1
1573,18.53214286,5.714285714,68.57142857,1166.142857,516220,579692,46103,1142015,0
1574,30.61932203,5.966101695,94.03389831,1497.169492,695527,369115,46478,1111120,0
1575,31.24215385,6.164835165,89.46153846,1537.406593,442741,287278,43908,773927,0
1576,22.1,5.615384615,75.57692308,1219.653846,259984,372428,31507,663919,0
1577,39.97375,1.75,130.25,1998.5,483044,102395,20913,606352,0
1578,47.84837037,6.444444444,126.1111111,1995.777778,407075,130854,29168,567097,0
1579,20.03375,4.833333333,71.33333333,1631.5,197990,333388,29678,561056,0
1580,18.1925,5.074074074,60.96296296,1408.055556,193661,278717,30621,502999,0
1581,20.3776087,4.869565217,67.95652174,1279.695652,172260,297084,29002,498346,0
1582,26.4498867,5.408866995,87.31034483,1623.793103,266172,204186,26377,496735,0
1583,15.46,5.0,60.8,1196.0,108625,305300,21685,435610,0
1584,29.942625,4.5,106.225,1480.575,246678,140718,21908,409304,0
1585,20.7206,3.52,74.4,1397.8,104932,177217,22449,304598,0
1586,22.36209302,4.88372093,72.58139535,1743.44186,182746,104949,12340,300035,0
1587,27.46483636,4.872727273,86.45454545,1723.0,145324,118282,13902,277508,0
1588,46.5274,7.04,131.6,1596.92,184659,63720,15678,264057,0
1589,46.06451282,6.487179487,125.4358974,1835.846154,202998,46749,13639,263386,0
1590,57.92693548,6.161290323,149.7096774,2283.112903,185948,54990,12486,253424,0
1591,27.23911864,3.033898305,91.61016949,1677.949153,130129,83982,14246,228357,0
1592,16.20874359,4.461538462,63.56410256,1650.205128,149523,60812,8563,218898,0
1593,18.64264,4.84,67.0,1698.64,127525,73358,9813,210696,0
1594,31.38814286,6.714285714,111.0,1711.571429,67995,123251,11941,203187,0
1595,22.78208333,4.916666667,81.66666667,1847.666667,114474,65636,10353,190463,0
1596,12.35588235,4.647058824,53.88235294,1366.294118,84182,89102,8029,181313,0
1597,26.3525,0.0,80.0,1498.0,74781,93233,9702,177716,0
1598,37.31523077,4.323076923,103.6769231,1873.261538,131369,31332,9944,172645,0
1599,43.86363077,5.292307692,105.1692308,2083.523077,106412,56616,8387,171415,1
1600,34.02059211,5.552631579,99.0,1920.026316,128508,33628,7216,169352,1
1601,36.21929825,6.473684211,94.33333333,1424.666667,96824,62889,9631,169344,0
1602,93.71425,8.0,225.0,2979.0,135036,20821,8335,164192,0
1603,107.4521429,8.0,182.5714286,2425.428571,121815,32043,6273,160131,1
1604,12.32981818,4.818181818,53.81818182,1367.272727,74796,78017,6562,159375,0
1605,19.00794118,5.205882353,66.97058824,1292.352941,84457,66592,7408,158457,0
1606,28.60820513,4.756410256,92.82051282,2043.820513,113448,24860,6621,144929,0
1607,21.70216667,4.9,79.76666667,1536.0,55479,80639,6702,142820,0
1608,78.07322727,7.672727273,192.4,2598.818182,109050,19167,8496,136713,0
1609,17.182,5.0,74.0,1994.0,76885,48044,5879,130808,0
1610,22.90364865,5.405405405,75.64864865,1364.0,50767,70830,6221,127818,0
1611,39.39984314,5.784313725,117.7058824,2151.647059,98187,21163,7130,126480,0
1612,32.06304348,5.956521739,89.34782609,1472.826087,68954,47681,6007,122642,1
1613,26.51269565,4.02173913,93.58695652,1933.021739,88741,24313,6134,119188,0
1614,31.1045119,4.547619048,93.01190476,1699.119048,47024,62769,8487,118280,0
1615,43.54851613,1.35483871,137.7741935,2261.193548,54443,55929,7821,118193,0
1616,49.28583333,6.0,145.0,1963.666667,83036,28671,6402,118109,0
1617,19.93814035,5.649122807,76.31578947,1205.192982,55978,55682,4694,116354,0
1618,30.65053846,6.346153846,95.0,1136.692308,84707,19714,4500,108921,0
1619,53.78571429,6.0,124.8571429,1855.0,67720,29356,4915,101991,1
1620,37.4265,6.2,104.2,1796.6,48109,42607,5501,96217,0
1621,65.56875,8.0,167.25,1998.0,77309,14859,3582,95750,0
1622,37.46857143,5.857142857,103.4285714,1718.571429,42230,44378,5788,92396,0
1623,107.6705126,8.277310924,196.3361345,2521.092437,70504,15715,3370,89589,1
1624,39.35238095,5.0,98.04761905,1928.714286,69864,12219,3336,85419,0
1625,82.06090909,7.727272727,199.7272727,2790.454545,67584,12137,4516,84237,1
1626,24.09525,6.25,68.75,1498.25,21243,58183,4671,84097,0
1627,50.96109091,6.181818182,135.2909091,1971.163636,61703,14957,4751,81411,1
1628,19.37890909,4.863636364,61.27272727,1470.909091,41930,31678,2893,76501,0
1629,26.803,5.428571429,85.71428571,1310.0,42190,29352,4491,76033,0
1630,32.93965169,6.348314607,114.8202247,1615.370787,51394,21919,2674,75987,0
1631,42.66935185,5.907407407,118.1851852,2095.185185,56579,13776,2958,73313,0
1632,19.08518182,3.727272727,68.90909091,1180.545455,29243,36514,5466,71223,0
1633,35.28132353,5.176470588,113.3529412,2106.5,50334,16077,3927,70338,0
1634,29.26025,5.95,90.625,1462.3625,44407,21504,2437,68348,0
1635,64.59222222,6.777777778,178.5555556,2011.555556,36344,26815,4304,67463,0
1636,33.25025,6.166666667,112.75,1475.0,15898,45202,4279,65379,0
1637,72.79589474,6.210526316,166.3157895,3041.0,41339,18779,3573,63691,0
1638,13.63642857,4.714285714,69.0,1424.857143,27156,31727,2292,61175,0
1639,30.99513158,5.789473684,101.8947368,1905.631579,35391,22710,2626,60727,0
1640,23.322,3.75,84.2,1853.9,43257,14483,2276,60016,0
1641,11.14333333,5.0,50.0,998.0,17499,37013,2651,57163,0
1642,16.59192308,5.0,52.84615385,998.0,21000,33462,1967,56429,0
1643,17.34364706,4.745098039,70.92156863,1683.607843,32790,20394,3084,56268,0
1644,35.81481651,6.293577982,117.4311927,1921.46789,37407,14943,3111,55461,0
1645,10.42388889,5.0,52.44444444,1095.777778,23368,27704,2755,53827,0
1646,47.361875,3.75,113.375,1774.8125,38385,13207,2161,53753,1
1647,15.20916667,5.0,53.0,998.0,17121,32009,4187,53317,0
1648,66.58842105,5.736842105,172.3157895,2934.631579,43812,6173,2176,52161,0
1649,15.14,5.0,64.0,1382.75,20952,28713,1975,51640,0
1650,14.293,4.6,75.4,1479.0,28815,19982,2494,51291,0
1651,113.2693333,8.0,246.3333333,2994.666667,36755,11684,2278,50717,1
1652,38.72769231,5.538461538,114.6538462,2178.192308,39850,8254,1797,49901,1
1653,34.9090566,5.603773585,104.2264151,1805.924528,38468,7568,1833,47869,1
1654,30.5976,1.8,97.6,1757.6,37766,8327,1727,47820,0
1655,31.5255,5.166666667,109.6666667,1861.833333,32402,12941,2375,47718,0
1656,27.4386,6.34,85.28,1452.0,31507,13991,2116,47614,1
1657,32.98557692,6.230769231,94.03846154,1528.807692,27414,16457,2903,46774,1
1658,25.39952941,4.647058824,78.85294118,1891.588235,33388,10669,2195,46252,0
1659,77.41666667,7.0,188.3333333,2876.0,30516,12648,2554,45718,1
1660,17.03876744,5.302325581,73.48837209,1374.046512,20138,22842,2345,45325,0
1661,30.3775,6.3125,94.0625,935.625,15487,27046,2740,45273,0
1662,21.02333333,5.0,92.33333333,1729.333333,26973,16352,1643,44968,0
1663,13.48615385,5.0,52.38461538,1028.923077,16604,26330,1706,44640,0
1664,52.95719388,5.653061224,146.122449,2031.469388,35025,7000,2373,44398,0
1665,61.86283333,6.833333333,184.1666667,2748.333333,18919,22246,3118,44283,0
1666,21.6,6.0,64.625,1496.0,17299,24382,1991,43672,0
1667,137.5695455,8.0,223.5454545,2813.0,38059,3554,1707,43320,0
1668,19.31857143,5.0,66.42857143,1348.285714,24098,16544,2412,43054,1
1669,26.97346154,3.076923077,85.69230769,1515.282051,23530,13509,2116,39155,0
1670,22.95871429,6.285714286,80.0,998.0,22143,14947,1235,38325,0
1671,22.77681818,5.272727273,92.36363636,1837.363636,23112,13435,1715,38262,0
1672,45.6995,6.0,114.0,1854.2,25844,9356,2833,38033,1
1673,17.44569231,4.692307692,68.26923077,1791.230769,27515,8062,2183,37760,0
1674,34.93603125,5.25,97.71875,1820.65625,20847,13308,3193,37348,1
1675,59.0,7.0,166.0,1798.0,25058,9826,1965,36849,0
1676,11.370625,5.0,48.0,1518.0,21589,12727,1720,36036,0
1677,39.70773684,4.842105263,117.5789474,2719.842105,22301,10844,1742,34887,1
1678,9.5628,4.6,50.0,996.0,13743,18028,2910,34681,0
1679,8.17,5.0,40.0,1108.0,11787,20428,1778,33993,0
1680,26.29166667,5.6,74.73333333,1186.333333,10510,21048,2054,33612,1
1681,52.085,8.0,223.8333333,1969.0,26217,4733,1605,32555,0
1682,9.8628,5.0,50.0,1090.4,15619,14683,2172,32474,0
1683,158.7922667,7.466666667,293.5333333,3005.4,27676,3179,1427,32282,0
1684,32.898125,5.333333333,116.2916667,2081.375,23830,5733,1427,30990,0
1685,32.33086957,5.891304348,103.1086957,1482.5,17747,11498,1139,30384,0
1686,17.22277778,4.888888889,70.0,1615.333333,16639,11062,1685,29386,0
1687,24.84390244,4.756097561,84.92682927,1982.756098,22641,5333,1306,29280,0
1688,16.011,5.0,51.77777778,998.0,12758,15123,603,28484,0
1689,25.94322222,4.777777778,67.0,1372.666667,12558,13791,2050,28399,0
1690,34.19,6.0,103.0,1794.0,17779,9229,1364,28372,0
1691,13.11525,4.75,50.875,1430.75,16364,9970,1236,27570,0
1692,22.455,6.0,92.30769231,1466.307692,15888,10273,1243,27404,0
1693,83.50125,6.5,213.5,3071.0,19279,6342,1520,27141,0
1694,16.05676923,4.923076923,67.0,1703.153846,17216,8124,1372,26712,0
1695,22.69,4.8,82.2,1773.7,18774,6356,1259,26389,0
1696,85.82946154,8.0,213.1538462,1969.0,16685,7869,1773,26327,0
1697,13.88308333,4.75,47.75,1373.75,8314,16174,1546,26034,0
1698,13.24516667,4.833333333,66.66666667,1506.5,12942,11027,1526,25495,0
1699,36.52419118,5.176470588,113.3529412,2106.5,17272,6560,1503,25335,0
1700,25.3433871,5.193548387,95.09677419,1802.774194,14993,8499,1328,24820,0
1701,17.82333333,4.666666667,70.33333333,1298.666667,11702,11838,1251,24791,0
1702,76.5922,8.0,184.0,2396.4,13693,9740,1307,24740,0
1703,43.97,6.6,115.3,1634.2,14939,8164,823,23926,1
1704,43.06842105,6.254385965,104.2017544,2222.710526,19985,2251,1582,23818,1
1705,44.14181818,6.545454545,144.6363636,2242.636364,16079,6909,808,23796,1
1706,43.08,4.666666667,105.0,2239.666667,15840,6227,1674,23741,0
1707,33.798,0.0,96.0,1797.4,14927,6204,2537,23668,0
1708,9.492272727,4.909090909,40.81818182,850.2727273,8540,13613,1160,23313,0
1709,49.82277778,6.0,115.8333333,1746.944444,15723,6275,1275,23273,0
1710,19.45142857,3.571428571,61.0,1197.0,10500,10953,1716,23169,0
1711,32.09,4.0,98.2,1754.4,10948,10731,1292,22971,0
1712,37.00904545,4.590909091,114.6818182,2208.090909,15968,5472,1432,22872,0
1713,145.6466667,6.0,283.0,5000.0,18681,3073,1018,22772,0
1714,36.38445588,4.5,125.7058824,2294.764706,17664,3928,1118,22710,0
1715,64.109625,6.75,202.125,2778.0,14317,6906,1416,22639,0
1716,36.01325,6.0,151.6666667,2048.666667,16395,5642,590,22627,0
1717,11.389,4.142857143,53.0,1308.285714,8824,12092,1219,22135,0
1718,115.533,8.0,250.0,2998.0,18962,1955,1130,22047,0
1719,47.52333333,6.0,128.8888889,1886.555556,13742,7360,806,21908,1
1720,20.7195,4.71875,81.375,1950.90625,15721,4691,1025,21437,0
1721,50.94,6.266666667,138.2833333,1986.766667,17287,2580,1153,21020,1
1722,37.01736842,4.736842105,97.57894737,2697.368421,14650,5055,821,20526,1
1723,20.43008333,4.791666667,69.875,1773.0,16009,3657,759,20425,0
1724,29.88478947,4.736842105,109.1052632,2238.631579,11350,7898,1069,20317,0
1725,51.646,0.0,110.0,1995.0,13205,5339,1337,19881,0
1726,18.76848837,4.860465116,67.02325581,1391.023256,11615,6812,1124,19551,1
1727,30.236875,4.5,110.0,2316.0,14903,3416,962,19281,0
1728,7.92,4.0,33.33333333,868.3333333,10144,8164,819,19127,0
1729,37.52210345,3.896551724,107.3793103,2084.37931,13808,4106,1127,19041,0
1730,27.13,5.768421053,96.05263158,1774.778947,11392,7033,607,19032,1
1731,39.7374,4.6,115.0,2234.4,10504,7216,1223,18943,0
1732,19.9680625,2.8125,55.375,592.5625,9199,8794,862,18855,0
1733,41.38957143,7.285714286,105.7142857,1545.428571,9923,7915,956,18794,1
1734,31.195,6.0,105.875,1755.75,12651,5480,572,18703,0
1735,26.97522727,5.863636364,88.09090909,1460.795455,12409,5835,402,18646,0
1736,135.1055,6.5,309.0,3999.0,15809,1712,660,18181,0
1737,10.83275,5.0,45.0,1242.0,9062,7915,842,17819,0
1738,30.99,0.0,105.0,335.0,13595,3665,545,17805,0
1739,18.513,4.6,76.0,1599.0,10770,6402,614,17786,0
1740,23.0525,5.0,55.0,1406.0,7655,8604,1224,17483,0
1741,42.74666667,5.0,128.5,2548.833333,14308,2229,507,17044,0
1742,264.675,7.0,420.0,6208.0,11874,3314,862,16050,0
1743,23.01661538,4.730769231,90.88461538,1709.538462,12026,3357,500,15883,0
1744,23.16515789,3.947368421,82.15789474,1817.315789,9251,5721,750,15722,0
1745,28.60918919,5.945945946,100.5945946,1387.621622,9923,5198,394,15515,0
1746,52.19640625,5.3125,126.5,2323.9375,10092,4549,831,15472,0
1747,20.36464286,5.857142857,82.25,1534.392857,10255,4508,680,15443,1
1748,13.70454545,4.818181818,47.45454545,1384.0,5345,9177,758,15280,0
1749,46.5274,7.04,131.6,1596.92,12702,1872,687,15261,0
1750,25.2075,5.0,80.5,1753.0,8670,5639,896,15205,0
1751,31.30566667,6.259259259,96.92592593,1587.222222,11139,3083,580,14802,0
1752,36.64326667,4.466666667,88.73333333,2284.133333,11326,2669,732,14727,0
1753,32.1815,6.0,99.0,1448.6,9456,4698,446,14600,0
1754,14.333375,4.5625,59.875,1183.25,6253,7626,705,14584,0
1755,94.098125,8.0,190.0,2967.0,10197,3779,592,14568,1
1756,26.0,5.0,70.0,1597.0,1928,11749,826,14503,0
1757,25.17006452,5.516129032,79.30645161,1523.741935,10384,3549,567,14500,1
1758,41.59161538,6.461538462,111.3076923,1624.769231,9353,4675,447,14475,0
1759,32.723,3.6,96.0,1498.0,7501,5792,843,14136,0
1760,14.22409091,4.727272727,64.45454545,1353.363636,6432,6488,611,13531,0
1761,22.12540909,5.5,75.09090909,1622.681818,7348,5010,583,12941,0
1762,26.19775,4.625,77.0,1495.0,6035,6259,639,12933,0
1763,27.09825,4.666666667,91.75,2247.333333,10004,2299,558,12861,0
1764,32.4898913,5.304347826,113.2826087,2093.021739,6968,4798,725,12491,0
1765,62.39565385,4.384615385,135.5,2972.307692,9681,2086,672,12439,0
1766,78.74625,8.0,176.25,1997.0,10686,1137,456,12279,1
1767,21.847,6.090909091,70.72727273,1052.272727,6718,5268,286,12272,0
1768,20.37,5.642857143,74.21428571,1324.357143,9083,2635,475,12193,0
1769,20.27896296,4.111111111,72.85185185,1832.888889,7849,3391,624,11864,0
1770,33.12857143,5.285714286,103.0,1914.714286,6578,4605,676,11859,0
1771,20.6695,4.75,88.0,1586.0,6465,4585,752,11802,0
1772,7.712,5.0,29.0,899.0,5380,5631,602,11613,0
1773,42.2862,6.0,113.8,1740.0,4620,6036,862,11518,0
1774,13.2053,6.0,35.8,679.0,4991,5725,684,11400,0
1775,29.151,5.0,89.0,2526.5,8179,2643,467,11289,0
1776,108.7471951,7.853658537,207.6097561,2304.97561,8583,1992,590,11165,1
1777,18.2955625,4.875,70.25,1836.5,9537,1356,264,11157,0
1778,12.49833333,5.0,48.66666667,1336.666667,3886,6369,540,10795,0
1779,18.88233333,4.666666667,74.0,1523.333333,6374,3793,618,10785,0
1780,18.76285714,4.714285714,80.42857143,1612.928571,6979,3265,469,10713,0
1781,32.11766667,4.666666667,115.3333333,2362.0,7799,2252,432,10483,0
1782,20.1241875,4.875,79.875,1836.875,7384,2456,495,10335,0
1783,39.725,6.8,110.0,1592.0,8812,1160,342,10314,0
1784,114.8758333,8.0,235.0,2979.0,8171,1370,387,9928,0
1785,19.71783333,4.0,98.0,1995.0,6215,3099,599,9913,0
1786,38.7525,0.0,165.0,2488.0,6373,3227,196,9796,0
1787,59.43242424,7.0,150.4545455,1981.818182,7759,1532,437,9728,0
1788,41.616,4.6,125.36,2336.52,7675,1524,527,9726,0
1789,16.4455,4.666666667,78.0,1741.0,6332,2775,447,9554,0
1790,106.5488889,8.0,210.0,2976.333333,6850,2261,433,9544,1
1791,158.976,8.0,326.0,3295.0,6552,2319,464,9335,0
1792,58.46907407,6.444444444,148.5185185,2174.037037,6576,1886,576,9038,1
1793,44.30857143,6.714285714,108.0,1663.928571,5232,3365,434,9031,0
1794,45.59125,5.25,104.1666667,2027.833333,5516,2885,426,8827,0
1795,45.76307692,5.307692308,109.0769231,2053.0,5603,2720,481,8804,1
1796,30.352,4.4,99.0,2117.6,5568,2818,380,8766,0
1797,14.7754,4.8,51.4,1428.4,3945,4217,507,8669,0
1798,23.22409091,4.909090909,82.0,1938.0,5241,2923,432,8596,0
1799,116.545,8.0,230.0,2981.0,7405,604,410,8419,0
1800,24.674,0.0,60.0,160.0,3316,4378,523,8217,0
1801,23.16515789,3.947368421,82.15789474,1817.315789,5333,2338,509,8180,0
1802,36.70125,4.875,91.75,2019.75,5562,2158,394,8114,0
1803,27.78966667,4.666666667,110.6666667,2050.333333,5807,1835,358,8000,0
1804,11.74,5.0,63.0,1405.0,3288,4041,535,7864,0
1805,55.25,6.0,177.0,1997.0,5669,1615,416,7700,0
1806,25.29875,4.5,94.0,1998.0,4876,2052,581,7509,0
1807,53.792,6.0,134.3333333,1730.0,6440,715,315,7470,0
1808,25.08266667,4.533333333,93.6,2127.333333,5920,1202,290,7412,0
1809,22.95383333,5.0,67.33333333,1908.166667,5028,1967,408,7403,0
1810,33.70615385,6.153846154,120.1538462,1750.615385,5231,1724,325,7280,0
1811,17.587,4.083333333,73.08333333,1363.5,4385,2444,361,7190,0
1812,37.44666667,2.611111111,120.3333333,2085.055556,4736,2086,328,7150,0
1813,285.247,7.2,428.2,5577.8,6159,696,290,7145,0
1814,42.5595,6.166666667,131.6666667,2313.666667,3765,2988,293,7046,0
1815,20.9225,5.375,68.875,1272.4375,4288,2466,288,7042,0
1816,55.4225,6.0,221.0,3498.0,5742,962,280,6984,0
1817,14.94,5.2,59.6,958.6,2596,4087,248,6931,0
1818,18.657,5.0,59.58333333,1407.333333,3235,3221,347,6803,0
1819,60.9552,5.5,146.0,2588.6,4874,1635,240,6749,1
1820,17.31241935,4.967741935,66.35483871,1655.741935,4391,1998,322,6711,0
1821,29.57028571,5.0,84.0,1997.142857,4506,1780,357,6643,1
1822,60.87,6.75,228.0,1984.0,5254,987,245,6486,0
1823,17.31777778,3.666666667,58.44444444,1152.888889,2751,3133,545,6429,0
1824,20.74,5.0,75.0,1695.0,3336,2778,303,6417,0
1825,70.31925,4.5,199.0,4123.5,5517,634,182,6333,0
1826,15.16166667,4.666666667,75.0,1594.0,4083,1816,264,6163,0
1827,30.86290909,4.454545455,105.5454545,2458.909091,5124,782,214,6120,0
1828,19.895,4.8,94.0,1742.6,3575,1777,230,5582,0
1829,24.35,6.0,60.0,698.0,3239,1992,347,5578,0
1830,26.59125,4.125,108.625,1911.75,3624,1779,157,5560,0
1831,37.350625,5.375,121.0625,1972.8125,4222,987,269,5478,0
1832,48.09553571,5.107142857,117.7857143,2315.0,4515,629,254,5398,0
1833,16.29053333,4.8,57.86666667,1645.133333,3496,1529,230,5255,0
1834,84.60125,6.5,220.5,3071.0,4108,823,236,5167,0
1835,30.0062,3.2,115.4666667,2245.6,4066,816,281,5163,0
1836,20.20388889,4.777777778,82.33333333,1775.777778,3083,1791,271,5145,0
1837,31.7425,4.833333333,119.6666667,2116.0,3862,968,225,5055,0
1838,18.84548718,4.076923077,87.07692308,2326.358974,4300,583,142,5025,0
1839,36.90769355,4.5,126.1451613,2344.0,4009,736,239,4984,0
1840,19.055,4.6,89.2,1827.8,3557,1204,177,4938,0
1841,13.1466,4.8,55.4,1144.8,2264,2215,319,4798,0
1842,55.2,6.0,163.5,2696.5,3148,1197,304,4649,0
1843,22.127,5.0,83.0,1721.5,2402,1783,249,4434,0
1844,43.9745,4.5,98.0,2309.0,2866,1257,246,4369,0
1845,95.29916667,6.333333333,253.6666667,3764.333333,3666,509,161,4336,0
1846,9.358333333,4.333333333,47.0,1324.0,2153,1952,210,4315,0
1847,28.803,4.8,111.2,2126.8,3361,766,146,4273,0
1848,18.615,5.2,69.6,1330.4,2136,1830,192,4158,0
1849,23.245,4.5,98.0,1998.0,3056,857,211,4124,0
1850,14.350125,4.875,59.5,1642.875,2841,1076,172,4089,0
1851,59.4905,5.0,137.5,2734.5,3548,407,132,4087,0
1852,53.62733333,0.0,122.6666667,2331.333333,2908,885,275,4068,0
1853,40.7645,4.333333333,133.3333333,2634.222222,3098,688,211,3997,0
1854,44.62833333,4.333333333,127.6666667,3100.333333,3076,841,79,3996,1
1855,43.26150943,5.905660377,135.3773585,2276.0,3320,486,188,3994,1
1856,27.935,5.0,103.5,1833.0,2404,1263,288,3955,0
1857,76.71,0.0,336.0,0.0,3047,716,147,3910,0
1858,56.15916667,5.5,174.3333333,3199.0,2315,1357,158,3830,0
1859,24.84,5.0,102.0,2244.0,2845,743,145,3733,0
1860,11.7129,4.0,69.0,1864.8,3225,408,79,3712,0
1861,81.295,8.0,250.0,2998.0,3214,375,115,3704,0
1862,64.50769231,6.846153846,144.2307692,2048.538462,2345,1140,216,3701,1
1863,12.47666667,4.666666667,58.66666667,1498.0,2200,1311,174,3685,0
1864,38.48247059,4.882352941,90.94117647,2953.588235,2940,589,142,3671,1
1865,9.465666667,4.666666667,50.0,996.0,1470,2050,150,3670,0
1866,360.755,6.0,410.0,5341.0,3251,290,123,3664,0
1867,35.34,5.0,118.0,1781.0,3095,421,137,3653,0
1868,16.67175,4.5,74.0,1541.5,2242,1202,190,3634,0
1869,20.31264706,5.352941176,63.29411765,1344.823529,1894,1536,186,3616,1
1870,273.755,6.0,381.0,5935.0,3106,257,108,3471,0
1871,14.4382,4.9,64.2,1891.7,2640,707,101,3448,0
1872,134.789,8.0,390.0,4395.0,3098,192,124,3414,0
1873,13.191,5.0,51.33333333,1431.333333,1446,1739,180,3365,0
1874,30.081,4.0,110.0,2254.0,2235,874,225,3334,0
1875,30.839,4.6,121.0,2378.0,2085,1052,189,3326,0
1876,107.6705126,8.277310924,196.3361345,2521.092437,2951,270,79,3300,1
1877,54.2675,5.666666667,114.0,1998.0,2250,741,142,3133,1
1878,55.62,6.0,145.75,2460.75,1900,988,177,3065,0
1879,121.77,6.666666667,316.3333333,3740.0,2631,279,121,3031,0
1880,37.32636,4.76,101.12,2349.08,2443,460,121,3024,0
1881,11.745,5.0,51.0,998.0,1402,1392,185,2979,0
1882,15.40377778,5.0,60.11111111,1593.111111,2278,584,76,2938,0
1883,35.86943902,5.585365854,117.0243902,1980.634146,2459,357,101,2917,0
1884,57.22905851,5.234042553,120.4255319,2309.340426,2114,566,203,2883,1
1885,20.49710714,4.142857143,72.42857143,1824.428571,1958,741,139,2838,0
1886,28.9602,4.4,100.8,1936.6,2170,522,134,2826,0
1887,18.16715385,4.692307692,70.30769231,1932.153846,2024,627,134,2785,0
1888,21.91166667,4.666666667,88.0,1586.0,1420,1202,122,2744,0
1889,46.60136364,6.0,110.0,2393.0,2172,384,104,2660,1
1890,14.76166667,4.666666667,75.0,1594.0,1581,830,103,2514,0
1891,11.28285714,4.285714286,49.28571429,1337.714286,1390,960,103,2453,0
1892,7.863333333,5.0,44.0,1289.0,1715,644,94,2453,0
1893,158.823,4.5,250.0,3228.0,2046,199,120,2365,0
1894,87.487,0.0,188.0,3498.0,1577,653,107,2337,0
1895,57.22905851,5.234042553,120.4255319,2309.340426,1727,450,138,2315,1
1896,125.49625,8.0,282.25,3344.75,1866,354,79,2299,0
1897,69.397,5.0,173.0,3358.666667,1939,249,110,2298,0
1898,38.025,4.5,129.5,2614.0,1424,746,101,2271,0
1899,88.77777778,7.0,190.0,3377.444444,1556,562,128,2246,0
1900,28.96891667,5.0,72.625,1707.125,1368,718,154,2240,0
1901,13.382,2.5,48.0,1343.0,719,1317,131,2167,0
1902,23.8115,5.0,64.0,1298.0,564,1400,173,2137,0
1903,34.10357143,4.571428571,121.8571429,2555.285714,1704,280,106,2090,0
1904,33.495,0.0,81.0,285.0,1274,770,28,2072,0
1905,47.881,5.111111111,141.4444444,3106.666667,1492,504,56,2052,1
1906,18.19842857,5.0,87.71428571,1696.428571,1397,468,87,1952,0
1907,53.10142857,6.0,163.7142857,2679.285714,1528,317,99,1944,0
1908,35.37645833,6.0,103.0833333,1968.0,1464,369,92,1925,1
1909,17.5296,4.6,78.4,1549.8,1603,222,58,1883,0
1910,37.471875,5.5,114.5,2167.5,1383,413,62,1858,0
1911,43.89111111,5.666666667,130.5555556,2457.555556,1510,159,76,1745,0
1912,24.612,0.0,72.0,1339.0,1167,456,111,1734,0
1913,30.92666667,4.666666667,110.3333333,2328.333333,1233,389,90,1712,0
1914,59.05425,6.75,144.375,2417.875,1181,359,90,1630,1
1915,17.42714286,5.0,87.71428571,1696.428571,1156,401,72,1629,0
1916,45.78386047,4.813953488,106.3023256,2768.511628,1233,313,60,1606,1
1917,42.93428571,3.857142857,122.1428571,2308.285714,1072,480,53,1605,0
1918,23.585,5.8125,80.8125,1446.125,964,524,82,1570,1
1919,31.79107143,4.571428571,104.1428571,2211.071429,1208,262,66,1536,0
1920,15.764,5.0,66.0,1497.0,807,638,81,1526,0
1921,78.47722222,0.888888889,224.7777778,3196.555556,1283,139,92,1514,0
1922,88.46428571,0.0,230.0,3456.0,930,435,92,1457,0
1923,16.80266667,4.5,71.0,1764.0,1037,301,56,1394,0
1924,646.605,6.0,450.0,5733.0,1228,104,60,1392,0
1925,35.29583333,5.0,102.0,2129.0,874,434,83,1391,0
1926,36.35965,4.55,110.5,2345.1,1114,162,75,1351,0
1927,175.835,7.0,433.5,4493.5,1189,97,51,1337,0
1928,38.79428571,4.428571429,98.57142857,2755.571429,1014,235,41,1290,1
1929,146.2746154,5.769230769,234.8461538,4089.923077,1144,81,60,1285,0
1930,74.609,3.2,239.2,3640.2,1153,105,24,1282,0
1931,226.3833333,6.5,368.6666667,4857.0,1129,84,55,1268,0
1932,111.993,5.0,220.0,4988.0,1088,112,59,1259,0
1933,35.27,6.0,112.0714286,1574.428571,758,415,86,1259,0
1934,260.287,6.0,360.0,4308.0,1167,52,38,1257,0
1935,34.33029412,5.588235294,105.0,1962.058824,913,274,31,1218,1
1936,12.924,4.0,43.0,989.0,576,564,76,1216,0
1937,20.21333333,6.0,74.0,1329.0,659,480,77,1216,0
1938,110.0985,5.0,235.0,4957.0,1023,65,61,1149,0
1939,105.465,8.0,257.5,2981.0,965,117,56,1138,0
1940,35.72526667,4.4,121.0,2287.6,793,302,23,1118,0
1941,28.735,4.666666667,100.6666667,1590.0,730,335,47,1112,0
1942,23.16515789,3.947368421,82.15789474,1817.315789,683,362,52,1097,0
1943,13.44125,5.0,54.5,1304.0,712,317,39,1068,0
1944,107.7,5.0,274.0,3800.5,940,67,40,1047,0
1945,51.6415625,5.375,126.5,2376.75,842,161,43,1046,0
1946,20.35378947,4.789473684,67.68421053,1996.684211,784,178,41,1003,0
1947,18.53214286,5.714285714,68.57142857,1166.142857,516891,580488,46639,1144018,0
1948,30.61932203,5.966101695,94.03389831,1497.169492,645236,340499,42183,1027918,0
1949,31.24215385,6.164835165,89.46153846,1537.406593,433589,279849,43224,756662,0
1950,22.1,5.615384615,75.57692308,1219.653846,268726,386211,32061,686998,0
1951,39.97375,1.75,130.25,1998.5,513891,110402,22553,646846,0
1952,20.03375,4.833333333,71.33333333,1631.5,199330,339260,29628,568218,0
1953,47.84837037,6.444444444,126.1111111,1995.777778,401739,131716,29041,562496,0
1954,20.3776087,4.869565217,67.95652174,1279.695652,181696,310229,30028,521953,0
1955,26.4498867,5.408866995,87.31034483,1623.793103,278090,209762,27294,515146,0
1956,18.1925,5.074074074,60.96296296,1408.055556,195957,283920,31388,511265,0
1957,15.46,5.0,60.8,1196.0,107210,303170,21638,432018,0
1958,29.942625,4.5,106.225,1480.575,246736,140616,22096,409448,0
1959,16.20874359,4.461538462,63.56410256,1650.205128,207691,87928,12209,307828,0
1960,22.36209302,4.88372093,72.58139535,1743.44186,181714,101938,11877,295529,0
1961,20.7206,3.52,74.4,1397.8,94656,162704,20700,278060,0
1962,27.46483636,4.872727273,86.45454545,1723.0,142204,112139,13000,267343,0
1963,46.06451282,6.487179487,125.4358974,1835.846154,195958,44619,13503,254080,0
1964,46.5274,7.04,131.6,1596.92,177261,60713,15325,253299,0
1965,18.64264,4.84,67.0,1698.64,150608,88015,11691,250314,0
1966,57.92693548,6.161290323,149.7096774,2283.112903,176367,50852,11840,239059,0
1967,27.23911864,3.033898305,91.61016949,1677.949153,136248,87260,14703,238211,0
1968,12.35588235,4.647058824,53.88235294,1366.294118,97156,109354,9657,216167,0
1969,22.78208333,4.916666667,81.66666667,1847.666667,121072,68898,10552,200522,0
1970,34.02059211,5.552631579,99.0,1920.026316,143192,38041,8112,189345,1
1971,12.32981818,4.818181818,53.81818182,1367.272727,81953,90003,7223,179179,0
1972,31.38814286,6.714285714,111.0,1711.571429,61578,106659,10347,178584,0
1973,17.182,5.0,74.0,1994.0,104853,65633,8055,178541,0
1974,43.86363077,5.292307692,105.1692308,2083.523077,104782,55670,8206,168658,1
1975,28.60820513,4.756410256,92.82051282,2043.820513,131093,28542,7653,167288,0
1976,37.31523077,4.323076923,103.6769231,1873.261538,125112,29350,9610,164072,0
1977,93.71425,8.0,225.0,2979.0,134480,20480,8275,163235,0
1978,107.4521429,8.0,182.5714286,2425.428571,124011,31969,6470,162450,1
1979,26.3525,0.0,80.0,1498.0,63510,79440,8060,151010,0
1980,36.21929825,6.473684211,94.33333333,1424.666667,82986,52275,8332,143593,0
1981,19.00794118,5.205882353,66.97058824,1292.352941,76171,59101,6630,141902,0
1982,26.51269565,4.02173913,93.58695652,1933.021739,102081,27744,6971,136796,0
1983,78.07322727,7.672727273,192.4,2598.818182,105562,18354,8362,132278,0
1984,39.39984314,5.784313725,117.7058824,2151.647059,100733,22059,7556,130348,0
1985,22.90364865,5.405405405,75.64864865,1364.0,47376,65833,5520,118729,0
1986,43.54851613,1.35483871,137.7741935,2261.193548,53689,55338,7853,116880,0
1987,31.1045119,4.547619048,93.01190476,1699.119048,44752,59375,7882,112009,0
1988,19.93814035,5.649122807,76.31578947,1205.192982,52311,52053,4641,109005,0
1989,32.06304348,5.956521739,89.34782609,1472.826087,61475,41262,5114,107851,1
1990,21.70216667,4.9,79.76666667,1536.0,41226,59650,4805,105681,0
1991,49.28583333,6.0,145.0,1963.666667,72714,25008,5822,103544,0
1992,53.78571429,6.0,124.8571429,1855.0,67291,28718,4952,100961,1
1993,30.65053846,6.346153846,95.0,1136.692308,76053,17548,4046,97647,0
1994,37.46857143,5.857142857,103.4285714,1718.571429,40001,43304,5644,88949,0
1995,39.35238095,5.0,98.04761905,1928.714286,72599,12467,3377,88443,0
1996,65.56875,8.0,167.25,1998.0,70246,13476,3260,86982,0
1997,107.6705126,8.277310924,196.3361345,2521.092437,66309,14186,3154,83649,1
1998,26.803,5.428571429,85.71428571,1310.0,44076,30788,4839,79703,0
1999,50.96109091,6.181818182,135.2909091,1971.163636,60074,14527,4791,79392,1
2000,82.06090909,7.727272727,199.7272727,2790.454545,61994,11099,4077,77170,1
2001,24.09525,6.25,68.75,1498.25,19791,52312,4247,76350,0
2002,37.4265,6.2,104.2,1796.6,36108,31073,3921,71102,0
2003,35.28132353,5.176470588,113.3529412,2106.5,50530,15996,3969,70495,0
2004,32.93965169,6.348314607,114.8202247,1615.370787,46613,19133,2446,68192,0
2005,19.37890909,4.863636364,61.27272727,1470.909091,37783,27702,2503,67988,0
2006,17.34364706,4.745098039,70.92156863,1683.607843,37690,23971,3581,65242,0
2007,19.08518182,3.727272727,68.90909091,1180.545455,27264,32423,5045,64732,0
2008,42.66935185,5.907407407,118.1851852,2095.185185,49727,11908,2575,64210,0
2009,33.25025,6.166666667,112.75,1475.0,16349,43438,4169,63956,0
2010,23.322,3.75,84.2,1853.9,45493,14893,2330,62716,0
2011,64.59222222,6.777777778,178.5555556,2011.555556,34070,23742,3872,61684,0
2012,72.79589474,6.210526316,166.3157895,3041.0,39280,17343,3404,60027,0
2013,13.63642857,4.714285714,69.0,1424.857143,27258,30451,2056,59765,0
2014,14.293,4.6,75.4,1479.0,33050,23482,2910,59442,0
2015,35.81481651,6.293577982,117.4311927,1921.46789,39299,15927,3344,58570,0
2016,29.26025,5.95,90.625,1462.3625,35945,16348,1878,54171,0
2017,66.58842105,5.736842105,172.3157895,2934.631579,44502,6131,2165,52798,0
2018,17.44569231,4.692307692,68.26923077,1791.230769,37375,10808,2971,51154,0
2019,31.5255,5.166666667,109.6666667,1861.833333,34208,13845,2560,50613,0
2020,15.14,5.0,64.0,1382.75,20175,27016,1756,48947,0
2021,47.361875,3.75,113.375,1774.8125,34992,11709,2162,48863,1
2022,30.5976,1.8,97.6,1757.6,38475,8330,1783,48588,0
2023,30.99513158,5.789473684,101.8947368,1905.631579,28129,18188,1931,48248,0
2024,30.3775,6.3125,94.0625,935.625,16110,28620,2866,47596,0
2025,25.39952941,4.647058824,78.85294118,1891.588235,34187,10765,2284,47236,0
2026,21.02333333,5.0,92.33333333,1729.333333,27726,17102,1712,46540,0
2027,113.2693333,8.0,246.3333333,2994.666667,33694,10334,1964,45992,1
2028,34.9090566,5.603773585,104.2264151,1805.924528,36852,7142,1711,45705,1
2029,137.5695455,8.0,223.5454545,2813.0,40000,3847,1831,45678,0
2030,11.370625,5.0,48.0,1518.0,27025,16152,2224,45401,0
2031,27.4386,6.34,85.28,1452.0,29384,12929,1921,44234,1
2032,52.95719388,5.653061224,146.122449,2031.469388,34654,6782,2365,43801,0
2033,77.41666667,7.0,188.3333333,2876.0,29134,12152,2355,43641,1
2034,11.14333333,5.0,50.0,998.0,13353,27841,1914,43108,0
2035,38.72769231,5.538461538,114.6538462,2178.192308,34308,6813,1472,42593,1
2036,61.86283333,6.833333333,184.1666667,2748.333333,17858,20866,2975,41699,0
2037,17.03876744,5.302325581,73.48837209,1374.046512,18647,20896,2084,41627,0
2038,10.42388889,5.0,52.44444444,1095.777778,17630,21444,2083,41157,0
2039,59.0,7.0,166.0,1798.0,27545,10659,2149,40353,0
2040,24.84390244,4.756097561,84.92682927,1982.756098,31264,7269,1749,40282,0
2041,32.98557692,6.230769231,94.03846154,1528.807692,23394,13959,2357,39710,1
2042,16.59192308,5.0,52.84615385,998.0,13668,24281,1675,39624,0
2043,15.20916667,5.0,53.0,998.0,12514,23505,3145,39164,0
2044,22.77681818,5.272727273,92.36363636,1837.363636,23621,13556,1672,38849,0
2045,13.11525,4.75,50.875,1430.75,22240,14528,1809,38577,0
2046,17.22277778,4.888888889,70.0,1615.333333,21542,14391,2142,38075,0
2047,45.6995,6.0,114.0,1854.2,25663,9542,2687,37892,1
2048,16.05676923,4.923076923,67.0,1703.153846,24025,11909,1889,37823,0
2049,8.17,5.0,40.0,1108.0,12579,22620,1932,37131,0
2050,32.898125,5.333333333,116.2916667,2081.375,26570,6294,1652,34516,0
2051,39.70773684,4.842105263,117.5789474,2719.842105,21669,10425,1636,33730,1
2052,9.8628,5.0,50.0,1090.4,16220,14997,2228,33445,0
2053,13.48615385,5.0,52.38461538,1028.923077,12367,18943,1187,32497,0
2054,52.085,8.0,223.8333333,1969.0,25932,4578,1632,32142,0
2055,22.95871429,6.285714286,80.0,998.0,18545,12052,1137,31734,0
2056,158.7922667,7.466666667,293.5333333,3005.4,26883,2983,1317,31183,0
2057,34.19,6.0,103.0,1794.0,19391,10055,1454,30900,0
2058,13.24516667,4.833333333,66.66666667,1506.5,15220,13455,1838,30513,0
2059,20.43008333,4.791666667,69.875,1773.0,23591,5508,1199,30298,0
2060,22.69,4.8,82.2,1773.7,21393,7129,1523,30045,0
2061,9.5628,4.6,50.0,996.0,11433,15257,2579,29269,0
2062,21.6,6.0,64.625,1496.0,12089,15034,1191,28314,0
2063,37.00904545,4.590909091,114.6818182,2208.090909,19295,6707,1788,27790,0
2064,25.94322222,4.777777778,67.0,1372.666667,12083,13642,2061,27786,0
2065,10.83275,5.0,45.0,1242.0,13582,12259,1323,27164,0
2066,36.38445588,4.5,125.7058824,2294.764706,21017,4653,1313,26983,0
2067,13.88308333,4.75,47.75,1373.75,8266,16820,1535,26621,0
2068,22.455,6.0,92.30769231,1466.307692,14959,10269,1267,26495,0
2069,26.97346154,3.076923077,85.69230769,1515.282051,15998,8933,1442,26373,0
2070,83.50125,6.5,213.5,3071.0,18793,6030,1456,26279,0
2071,20.7195,4.71875,81.375,1950.90625,19294,5596,1272,26162,0
2072,19.31857143,5.0,66.42857143,1348.285714,13949,9384,2727,26060,1
2073,43.08,4.666666667,105.0,2239.666667,17116,6767,1818,25701,0
2074,11.389,4.142857143,53.0,1308.285714,9672,13848,1394,24914,0
2075,25.3433871,5.193548387,95.09677419,1802.774194,14916,8492,1338,24746,0
2076,19.45142857,3.571428571,61.0,1197.0,10732,10943,1790,23465,0
2077,32.09,4.0,98.2,1754.4,10977,11168,1296,23441,0
2078,43.06842105,6.254385965,104.2017544,2222.710526,19708,2177,1551,23436,1
2079,85.82946154,8.0,213.1538462,1969.0,14935,6840,1519,23294,0
2080,30.236875,4.5,110.0,2316.0,17894,4187,1168,23249,0
2081,49.82277778,6.0,115.8333333,1746.944444,15442,6261,1247,22950,0
2082,115.533,8.0,250.0,2998.0,19606,2089,1180,22875,0
2083,44.14181818,6.545454545,144.6363636,2242.636364,15093,6383,731,22207,1
2084,76.5922,8.0,184.0,2396.4,12461,8572,1114,22147,0
2085,17.82333333,4.666666667,70.33333333,1298.666667,10444,10359,1090,21893,0
2086,37.01736842,4.736842105,97.57894737,2697.368421,15641,5372,871,21884,1
2087,34.93603125,5.25,97.71875,1820.65625,12816,7687,1349,21852,1
2088,145.6466667,6.0,283.0,5000.0,17760,2917,949,21626,0
2089,7.92,4.0,33.33333333,868.3333333,10721,9359,933,21013,0
2090,43.97,6.6,115.3,1634.2,12825,7137,713,20675,1
2091,50.94,6.266666667,138.2833333,1986.766667,17078,2428,1162,20668,1
2092,29.88478947,4.736842105,109.1052632,2238.631579,11519,7554,1042,20115,0
2093,36.01325,6.0,151.6666667,2048.666667,14705,4856,537,20098,0
2094,37.52210345,3.896551724,107.3793103,2084.37931,14343,4319,1210,19872,0
2095,39.7374,4.6,115.0,2234.4,10572,7513,1252,19337,0
2096,64.109625,6.75,202.125,2778.0,12207,5874,1208,19289,0
2097,51.646,0.0,110.0,1995.0,12663,5085,1290,19038,0
2098,36.64326667,4.466666667,88.73333333,2284.133333,14516,3409,977,18902,0
2099,36.52419118,5.176470588,113.3529412,2106.5,12768,4834,1117,18719,0
2100,30.99,0.0,105.0,335.0,14116,3760,544,18420,0
2101,20.27896296,4.111111111,72.85185185,1832.888889,12102,5244,933,18279,0
2102,135.1055,6.5,309.0,3999.0,15773,1736,623,18132,0
2103,18.76848837,4.860465116,67.02325581,1391.023256,10636,6334,1027,17997,1
2104,33.798,0.0,96.0,1797.4,11407,4661,1919,17987,0
2105,27.09825,4.666666667,91.75,2247.333333,13709,3139,792,17640,0
2106,23.0525,5.0,55.0,1406.0,7688,8631,1211,17530,0
2107,42.74666667,5.0,128.5,2548.833333,14496,2280,504,17280,0
2108,9.492272727,4.909090909,40.81818182,850.2727273,6158,10140,862,17160,0
2109,7.712,5.0,29.0,899.0,7498,8607,900,17005,0
2110,18.513,4.6,76.0,1599.0,10293,5928,521,16742,0
2111,31.195,6.0,105.875,1755.75,11189,4658,461,16308,0
2112,13.70454545,4.818181818,47.45454545,1384.0,5685,9819,778,16282,0
2113,18.2955625,4.875,70.25,1836.5,13673,2082,406,16161,0
2114,23.16515789,3.947368421,82.15789474,1817.315789,9440,5707,731,15878,0
2115,27.13,5.768421053,96.05263158,1774.778947,9575,5566,477,15618,1
2116,264.675,7.0,420.0,6208.0,11391,3202,814,15407,0
2117,47.52333333,6.0,128.8888889,1886.555556,9688,5018,561,15267,1
2118,25.2075,5.0,80.5,1753.0,8622,5668,868,15158,0
2119,26.0,5.0,70.0,1597.0,2008,11929,834,14771,0
2120,23.01661538,4.730769231,90.88461538,1709.538462,11175,3090,480,14745,0
2121,32.723,3.6,96.0,1498.0,7722,6005,860,14587,0
2122,52.19640625,5.3125,126.5,2323.9375,9467,4148,802,14417,0
2123,62.39565385,4.384615385,135.5,2972.307692,11139,2422,798,14359,0
2124,20.36464286,5.857142857,82.25,1534.392857,9477,4241,616,14334,1
2125,41.38957143,7.285714286,105.7142857,1545.428571,7568,5763,688,14019,1
2126,20.1241875,4.875,79.875,1836.875,9699,3402,656,13757,0
2127,14.333375,4.5625,59.875,1183.25,5929,6965,642,13536,0
2128,20.37,5.642857143,74.21428571,1324.357143,10138,2864,501,13503,0
2129,46.5274,7.04,131.6,1596.92,11348,1552,559,13459,0
2130,25.17006452,5.516129032,79.30645161,1523.741935,9538,3229,513,13280,1
2131,41.59161538,6.461538462,111.3076923,1624.769231,8681,4177,370,13228,0
2132,26.29166667,5.6,74.73333333,1186.333333,4539,7741,897,13177,1
2133,29.151,5.0,89.0,2526.5,9208,3123,511,12842,0
2134,41.616,4.6,125.36,2336.52,10026,1997,710,12733,0
2135,16.4455,4.666666667,78.0,1741.0,8380,3684,592,12656,0
2136,31.30566667,6.259259259,96.92592593,1587.222222,9500,2535,476,12511,0
2137,26.19775,4.625,77.0,1495.0,5904,5952,582,12438,0
2138,94.098125,8.0,190.0,2967.0,8841,3086,459,12386,1
2139,19.9680625,2.8125,55.375,592.5625,5905,5813,535,12253,0
2140,14.22409091,4.727272727,64.45454545,1353.363636,6020,5665,531,12216,0
2141,13.2053,6.0,35.8,679.0,5077,5879,713,11669,0
2142,19.71783333,4.0,98.0,1995.0,7287,3609,673,11569,0
2143,32.11766667,4.666666667,115.3333333,2362.0,8397,2397,460,11254,0
2144,18.88233333,4.666666667,74.0,1523.333333,6596,3687,607,10890,0
2145,32.33086957,5.891304348,103.1086957,1482.5,6703,3793,373,10869,0
2146,22.12540909,5.5,75.09090909,1622.681818,5916,3904,441,10261,0
2147,33.12857143,5.285714286,103.0,1914.714286,5772,3884,528,10184,0
2148,23.16515789,3.947368421,82.15789474,1817.315789,6474,2893,622,9989,0
2149,26.97522727,5.863636364,88.09090909,1460.795455,6882,2894,180,9956,0
2150,108.7471951,7.853658537,207.6097561,2304.97561,7668,1708,537,9913,1
2151,27.78966667,4.666666667,110.6666667,2050.333333,7058,2188,448,9694,0
2152,114.8758333,8.0,235.0,2979.0,7804,1291,364,9459,0
2153,22.95383333,5.0,67.33333333,1908.166667,6321,2445,533,9299,0
2154,42.2862,6.0,113.8,1740.0,3820,4740,672,9232,0
2155,20.6695,4.75,88.0,1586.0,5113,3409,603,9125,0
2156,14.7754,4.8,51.4,1428.4,4087,4348,537,8972,0
2157,25.08266667,4.533333333,93.6,2127.333333,7131,1468,359,8958,0
2158,16.29053333,4.8,57.86666667,1645.133333,5934,2598,396,8928,0
2159,36.70125,4.875,91.75,2019.75,6009,2430,457,8896,0
2160,17.587,4.083333333,73.08333333,1363.5,5374,3007,459,8840,0
2161,158.976,8.0,326.0,3295.0,6290,2095,415,8800,0
2162,30.352,4.4,99.0,2117.6,5636,2744,362,8742,0
2163,23.22409091,4.909090909,82.0,1938.0,5339,2956,424,8719,0
2164,30.86290909,4.454545455,105.5454545,2458.909091,7244,1126,282,8652,0
2165,39.725,6.8,110.0,1592.0,7304,954,266,8524,0
2166,18.76285714,4.714285714,80.42857143,1612.928571,5619,2490,339,8448,0
2167,45.59125,5.25,104.1666667,2027.833333,5259,2758,398,8415,0
2168,45.76307692,5.307692308,109.0769231,2053.0,5371,2548,482,8401,1
2169,17.31241935,4.967741935,66.35483871,1655.741935,5253,2500,411,8164,0
2170,12.49833333,5.0,48.66666667,1336.666667,2889,4837,438,8164,0
2171,53.792,6.0,134.3333333,1730.0,7016,798,339,8153,0
2172,11.74,5.0,63.0,1405.0,3410,4117,555,8082,0
2173,24.674,0.0,60.0,160.0,3335,4220,513,8068,0
2174,116.545,8.0,230.0,2981.0,6961,547,390,7898,0
2175,25.29875,4.5,94.0,1998.0,5059,2233,605,7897,0
2176,58.46907407,6.444444444,148.5185185,2174.037037,5769,1579,514,7862,1
2177,32.1815,6.0,99.0,1448.6,4888,2376,224,7488,0
2178,29.57028571,5.0,84.0,1997.142857,4992,1883,405,7280,1
2179,18.84548718,4.076923077,87.07692308,2326.358974,6192,873,212,7277,0
2180,55.25,6.0,177.0,1997.0,5286,1559,406,7251,0
2181,106.5488889,8.0,210.0,2976.333333,5212,1625,273,7110,1
2182,15.16166667,4.666666667,75.0,1594.0,4618,2007,297,6922,0
2183,285.247,7.2,428.2,5577.8,5838,625,249,6712,0
2184,55.4225,6.0,221.0,3498.0,5422,877,288,6587,0
2185,20.74,5.0,75.0,1695.0,3417,2824,304,6545,0
2186,32.4898913,5.304347826,113.2826087,2093.021739,3641,2469,383,6493,0
2187,18.657,5.0,59.58333333,1407.333333,3178,3000,302,6480,0
2188,14.350125,4.875,59.5,1642.875,4412,1659,257,6328,0
2189,9.358333333,4.333333333,47.0,1324.0,3055,2945,319,6319,0
2190,30.0062,3.2,115.4666667,2245.6,4938,1024,333,6295,0
2191,60.87,6.75,228.0,1984.0,4959,945,220,6124,0
2192,12.47666667,4.666666667,58.66666667,1498.0,3608,2197,317,6122,0
2193,24.35,6.0,60.0,698.0,3350,2079,367,5796,0
2194,16.011,5.0,51.77777778,998.0,2639,2917,90,5646,0
2195,22.127,5.0,83.0,1721.5,3042,2234,317,5593,0
2196,23.245,4.5,98.0,1998.0,4137,1138,293,5568,0
2197,36.90769355,4.5,126.1451613,2344.0,4455,812,263,5530,0
2198,48.09553571,5.107142857,117.7857143,2315.0,4611,639,258,5508,0
2199,31.7425,4.833333333,119.6666667,2116.0,4197,1083,227,5507,0
2200,19.895,4.8,94.0,1742.6,3579,1680,211,5470,0
2201,60.9552,5.5,146.0,2588.6,3867,1240,263,5370,1
2202,78.74625,8.0,176.25,1997.0,4646,517,198,5361,1
2203,37.44666667,2.611111111,120.3333333,2085.055556,3574,1528,258,5360,0
2204,70.31925,4.5,199.0,4123.5,4668,533,124,5325,0
2205,20.9225,5.375,68.875,1272.4375,3294,1776,195,5265,0
2206,16.67175,4.5,74.0,1541.5,3205,1694,269,5168,0
2207,14.4382,4.9,64.2,1891.7,3917,1082,165,5164,0
2208,24.84,5.0,102.0,2244.0,3915,1023,189,5127,0
2209,19.055,4.6,89.2,1827.8,3674,1216,177,5067,0
2210,59.43242424,7.0,150.4545455,1981.818182,4119,662,216,4997,0
2211,26.59125,4.125,108.625,1911.75,3346,1507,112,4965,0
2212,37.350625,5.375,121.0625,1972.8125,3810,893,225,4928,0
2213,28.60918919,5.945945946,100.5945946,1387.621622,3081,1615,98,4794,0
2214,15.40377778,5.0,60.11111111,1593.111111,3661,966,135,4762,0
2215,40.7645,4.333333333,133.3333333,2634.222222,3642,792,253,4687,0
2216,43.9745,4.5,98.0,2309.0,2974,1380,250,4604,0
2217,14.94,5.2,59.6,958.6,1680,2775,145,4600,0
2218,55.2,6.0,163.5,2696.5,3039,1183,285,4507,0
2219,59.4905,5.0,137.5,2734.5,3811,453,153,4417,0
2220,76.71,0.0,336.0,0.0,3418,772,179,4369,0
2221,84.60125,6.5,220.5,3071.0,3483,693,182,4358,0
2222,20.49710714,4.142857143,72.42857143,1824.428571,3049,1091,206,4346,0
2223,81.295,8.0,250.0,2998.0,3683,468,143,4294,0
2224,13.191,5.0,51.33333333,1431.333333,1765,2251,220,4236,0
2225,20.20388889,4.777777778,82.33333333,1775.777778,2503,1433,204,4140,0
2226,11.28285714,4.285714286,49.28571429,1337.714286,2319,1646,175,4140,0
2227,107.6705126,8.277310924,196.3361345,2521.092437,3686,341,106,4133,1
2228,37.32636,4.76,101.12,2349.08,3280,647,184,4111,0
2229,35.34,5.0,118.0,1781.0,3461,459,154,4074,0
2230,38.48247059,4.882352941,90.94117647,2953.588235,3221,668,157,4046,1
2231,11.7129,4.0,69.0,1864.8,3478,465,85,4028,0
2232,27.935,5.0,103.5,1833.0,2392,1309,296,3997,0
2233,44.62833333,4.333333333,127.6666667,3100.333333,3030,815,86,3931,1
2234,95.29916667,6.333333333,253.6666667,3764.333333,3285,488,148,3921,0
2235,7.863333333,5.0,44.0,1289.0,2674,1100,146,3920,0
2236,18.16715385,4.692307692,70.30769231,1932.153846,2784,923,185,3892,0
2237,56.15916667,5.5,174.3333333,3199.0,2400,1290,151,3841,0
2238,28.803,4.8,111.2,2126.8,3026,658,126,3810,0
2239,44.30857143,6.714285714,108.0,1663.928571,2160,1401,172,3733,0
2240,30.081,4.0,110.0,2254.0,2418,954,262,3634,0
2241,28.9602,4.4,100.8,1936.6,2771,671,181,3623,0
2242,35.86943902,5.585365854,117.0243902,1980.634146,2954,466,129,3549,0
2243,20.31264706,5.352941176,63.29411765,1344.823529,1892,1481,168,3541,1
2244,134.789,8.0,390.0,4395.0,3172,211,131,3514,0
2245,11.745,5.0,51.0,998.0,1569,1562,229,3360,0
2246,33.70615385,6.153846154,120.1538462,1750.615385,2504,674,146,3324,0
2247,53.62733333,0.0,122.6666667,2331.333333,2384,692,222,3298,0
2248,14.76166667,4.666666667,75.0,1594.0,2058,1078,132,3268,0
2249,273.755,6.0,381.0,5935.0,2878,212,101,3191,0
2250,57.22905851,5.234042553,120.4255319,2309.340426,2270,642,226,3138,1
2251,360.755,6.0,410.0,5341.0,2842,209,72,3123,0
2252,121.77,6.666666667,316.3333333,3740.0,2657,260,112,3029,0
2253,46.60136364,6.0,110.0,2393.0,2459,432,125,3016,1
2254,42.5595,6.166666667,131.6666667,2313.666667,1656,1151,130,2937,0
2255,30.839,4.6,121.0,2378.0,1845,904,158,2907,0
2256,23.585,5.8125,80.8125,1446.125,1717,935,148,2800,1
2257,18.19842857,5.0,87.71428571,1696.428571,1987,633,135,2755,0
2258,54.2675,5.666666667,114.0,1998.0,1998,650,95,2743,1
2259,38.7525,0.0,165.0,2488.0,1860,823,54,2737,0
2260,43.26150943,5.905660377,135.3773585,2276.0,2230,313,135,2678,1
2261,34.10357143,4.571428571,121.8571429,2555.285714,2089,356,134,2579,0
2262,16.80266667,4.5,71.0,1764.0,1809,534,114,2457,0
2263,69.397,5.0,173.0,3358.666667,2051,265,120,2436,0
2264,158.823,4.5,250.0,3228.0,2066,187,104,2357,0
2265,38.025,4.5,129.5,2614.0,1461,750,105,2316,0
2266,28.96891667,5.0,72.625,1707.125,1320,723,162,2205,0
2267,13.382,2.5,48.0,1343.0,714,1343,141,2198,0
2268,17.42714286,5.0,87.71428571,1696.428571,1532,547,88,2167,0
2269,21.91166667,4.666666667,88.0,1586.0,1122,881,98,2101,0
2270,30.92666667,4.666666667,110.3333333,2328.333333,1512,466,111,2089,0
2271,17.5296,4.6,78.4,1549.8,1720,275,65,2060,0
2272,31.79107143,4.571428571,104.1428571,2211.071429,1623,345,89,2057,0
2273,43.89111111,5.666666667,130.5555556,2457.555556,1711,202,105,2018,0
2274,87.487,0.0,188.0,3498.0,1354,521,92,1967,0
2275,88.77777778,7.0,190.0,3377.444444,1369,482,92,1943,0
2276,23.8115,5.0,64.0,1298.0,501,1269,141,1911,0
2277,13.1466,4.8,55.4,1144.8,883,835,142,1860,0
2278,57.22905851,5.234042553,120.4255319,2309.340426,1382,348,101,1831,1
2279,15.764,5.0,66.0,1497.0,898,766,110,1774,0
2280,45.78386047,4.813953488,106.3023256,2768.511628,1327,342,77,1746,1
2281,36.35965,4.55,110.5,2345.1,1464,189,92,1745,0
2282,20.35378947,4.789473684,67.68421053,1996.684211,1311,309,81,1701,0
2283,55.62,6.0,145.75,2460.75,1021,540,119,1680,0
2284,38.79428571,4.428571429,98.57142857,2755.571429,1302,285,54,1641,1
2285,35.29583333,5.0,102.0,2129.0,898,462,84,1444,0
2286,646.605,6.0,450.0,5733.0,1263,122,58,1443,0
2287,12.924,4.0,43.0,989.0,650,670,94,1414,0
2288,35.37645833,6.0,103.0833333,1968.0,1073,269,50,1392,1
2289,23.16515789,3.947368421,82.15789474,1817.315789,858,455,69,1382,0
2290,111.993,5.0,220.0,4988.0,1177,123,49,1349,0
2291,59.05425,6.75,144.375,2417.875,990,300,59,1349,1
2292,88.46428571,0.0,230.0,3456.0,850,387,77,1314,0
2293,53.10142857,6.0,163.7142857,2679.285714,986,216,72,1274,0
2294,21.407,4.5,72.0,1974.0,895,317,56,1268,0
2295,28.735,4.666666667,100.6666667,1590.0,822,376,55,1253,0
2296,74.609,3.2,239.2,3640.2,1121,105,26,1252,0
2297,35.27,6.0,112.0714286,1574.428571,761,391,97,1249,0
2298,47.881,5.111111111,141.4444444,3106.666667,957,252,27,1236,1
2299,110.0985,5.0,235.0,4957.0,1103,67,58,1228,0
2300,260.287,6.0,360.0,4308.0,1137,48,35,1220,0
2301,34.33029412,5.588235294,105.0,1962.058824,903,233,26,1162,1
2302,8.4656,4.6,41.4,1182.4,919,194,29,1142,0
2303,107.7,5.0,274.0,3800.5,1016,71,43,1130,0
2304,78.47722222,0.888888889,224.7777778,3196.555556,941,93,72,1106,0
2305,51.6415625,5.375,126.5,2376.75,892,156,48,1096,0
2306,175.835,7.0,433.5,4493.5,944,85,50,1079,0
2307,93.42433333,5.0,233.0,2995.0,995,37,28,1060,0
2308,12.25,5.0,43.0,1325.0,759,249,46,1054,0
2309,200.19825,6.0,294.0,3586.0,920,66,45,1031,0
2310,146.2746154,5.769230769,234.8461538,4089.923077,902,67,48,1017,0
2311,18.53214286,5.714285714,68.57142857,1166.142857,515012,578953,46985,1140950,0
2312,30.61932203,5.966101695,94.03389831,1497.169492,582031,305736,37430,925197,0
2313,31.24215385,6.164835165,89.46153846,1537.406593,418915,270207,42908,732030,0
2314,22.1,5.615384615,75.57692308,1219.653846,269970,390458,32611,693039,0
2315,39.97375,1.75,130.25,1998.5,546276,120935,24270,691481,0
2316,20.03375,4.833333333,71.33333333,1631.5,196613,339141,29387,565141,0
2317,47.84837037,6.444444444,126.1111111,1995.777778,391643,131916,29146,552705,0
2318,20.3776087,4.869565217,67.95652174,1279.695652,186318,316975,30501,533794,0
2319,26.4498867,5.408866995,87.31034483,1623.793103,279372,208847,27336,515555,0
2320,18.1925,5.074074074,60.96296296,1408.055556,191060,278872,31329,501261,0
2321,15.46,5.0,60.8,1196.0,101864,290594,20767,413225,0
2322,16.20874359,4.461538462,63.56410256,1650.205128,274311,118934,16596,409841,0
2323,29.942625,4.5,106.225,1480.575,239139,138787,21996,399922,0
2324,18.64264,4.84,67.0,1698.64,171072,101278,13580,285930,0
2325,22.36209302,4.88372093,72.58139535,1743.44186,174610,96197,11134,281941,0
2326,20.7206,3.52,74.4,1397.8,84447,146631,18926,250004,0
2327,12.35588235,4.647058824,53.88235294,1366.294118,106534,127070,11281,244885,0
2328,27.46483636,4.872727273,86.45454545,1723.0,131261,100899,11582,243742,0
2329,46.06451282,6.487179487,125.4358974,1835.846154,187363,42921,13157,243441,0
2330,27.23911864,3.033898305,91.61016949,1677.949153,138716,88131,15023,241870,0
2331,46.5274,7.04,131.6,1596.92,166126,56378,14690,237194,0
2332,17.182,5.0,74.0,1994.0,135959,83515,10555,230029,0
2333,57.92693548,6.161290323,149.7096774,2283.112903,164258,47092,11295,222645,0
2334,34.02059211,5.552631579,99.0,1920.026316,159043,42648,9271,210962,1
2335,22.78208333,4.916666667,81.66666667,1847.666667,121789,68938,10254,200981,0
2336,12.32981818,4.818181818,53.81818182,1367.272727,86038,99554,7911,193503,0
2337,28.60820513,4.756410256,92.82051282,2043.820513,147262,31820,8846,187928,0
2338,107.4521429,8.0,182.5714286,2425.428571,126405,33031,6759,166195,1
2339,93.71425,8.0,225.0,2979.0,135216,20852,8428,164496,0
2340,43.86363077,5.292307692,105.1692308,2083.523077,99836,54904,7896,162636,1
2341,37.31523077,4.323076923,103.6769231,1873.261538,117214,27774,9203,154191,0
2342,26.51269565,4.02173913,93.58695652,1933.021739,114021,30863,8029,152913,0
2343,31.38814286,6.714285714,111.0,1711.571429,53119,88295,8761,150175,0
2344,39.39984314,5.784313725,117.7058824,2151.647059,102700,22879,8062,133641,0
2345,78.07322727,7.672727273,192.4,2598.818182,103578,18345,8233,130156,0
2346,19.00794118,5.205882353,66.97058824,1292.352941,68791,52879,5997,127667,0
2347,26.3525,0.0,80.0,1498.0,53118,66330,6484,125932,0
2348,36.21929825,6.473684211,94.33333333,1424.666667,70461,43892,7368,121721,0
2349,43.54851613,1.35483871,137.7741935,2261.193548,50275,53350,7633,111258,0
2350,22.90364865,5.405405405,75.64864865,1364.0,43638,59111,4820,107569,0
2351,31.1045119,4.547619048,93.01190476,1699.119048,41248,54439,7332,103019,0
2352,19.93814035,5.649122807,76.31578947,1205.192982,49257,49087,4568,102912,0
2353,53.78571429,6.0,124.8571429,1855.0,66134,28596,4880,99610,1
2354,39.35238095,5.0,98.04761905,1928.714286,74351,12622,3293,90266,0
2355,49.28583333,6.0,145.0,1963.666667,62540,21859,5262,89661,0
2356,30.65053846,6.346153846,95.0,1136.692308,69250,16044,3793,89087,0
2357,37.46857143,5.857142857,103.4285714,1718.571429,37658,41696,5493,84847,0
2358,26.803,5.428571429,85.71428571,1310.0,45170,32365,5129,82664,0
2359,32.06304348,5.956521739,89.34782609,1472.826087,46795,30202,3652,80649,1
2360,107.6705126,8.277310924,196.3361345,2521.092437,62806,13208,2880,78894,1
2361,65.56875,8.0,167.25,1998.0,61435,11841,2904,76180,0
2362,50.96109091,6.181818182,135.2909091,1971.163636,57218,14017,4739,75974,1
2363,17.34364706,4.745098039,70.92156863,1683.607843,42332,27106,4026,73464,0
2364,82.06090909,7.727272727,199.7272727,2790.454545,57945,10516,3942,72403,1
2365,35.28132353,5.176470588,113.3529412,2106.5,50022,15972,3943,69937,0
2366,24.09525,6.25,68.75,1498.25,17800,44859,3850,66509,0
2367,14.293,4.6,75.4,1479.0,36561,26411,3280,66252,0
2368,17.44569231,4.692307692,68.26923077,1791.230769,48149,13568,3973,65690,0
2369,23.322,3.75,84.2,1853.9,47303,15159,2365,64827,0
2370,33.25025,6.166666667,112.75,1475.0,16502,40516,3992,61010,0
2371,32.93965169,6.348314607,114.8202247,1615.370787,41390,16713,2352,60455,0
2372,35.81481651,6.293577982,117.4311927,1921.46789,40307,16508,3599,60414,0
2373,21.70216667,4.9,79.76666667,1536.0,23259,33265,2706,59230,0
2374,19.37890909,4.863636364,61.27272727,1470.909091,32487,23579,2001,58067,0
2375,72.79589474,6.210526316,166.3157895,3041.0,36873,16318,3246,56437,0
2376,19.08518182,3.727272727,68.90909091,1180.545455,24369,27460,4421,56250,0
2377,64.59222222,6.777777778,178.5555556,2011.555556,30467,20417,3495,54379,0
2378,42.66935185,5.907407407,118.1851852,2095.185185,42115,10110,2067,54292,0
2379,24.84390244,4.756097561,84.92682927,1982.756098,41492,9818,2399,53709,0
2380,31.5255,5.166666667,109.6666667,1861.833333,35462,14573,2749,52784,0
2381,13.11525,4.75,50.875,1430.75,29906,20333,2526,52765,0
2382,11.370625,5.0,48.0,1518.0,31129,18899,2612,52640,0
2383,13.63642857,4.714285714,69.0,1424.857143,24210,26432,1680,52322,0
2384,66.58842105,5.736842105,172.3157895,2934.631579,43146,5952,2104,51202,0
2385,16.05676923,4.923076923,67.0,1703.153846,32056,16065,2553,50674,0
2386,30.5976,1.8,97.6,1757.6,38938,8437,1885,49260,0
2387,30.3775,6.3125,94.0625,935.625,16412,29317,2936,48665,0
2388,137.5695455,8.0,223.5454545,2813.0,42399,4169,1963,48531,0
2389,37.4265,6.2,104.2,1796.6,24357,21220,2597,48174,0
2390,21.02333333,5.0,92.33333333,1729.333333,28044,17695,1736,47475,0
2391,25.39952941,4.647058824,78.85294118,1891.588235,34270,10827,2286,47383,0
2392,17.22277778,4.888888889,70.0,1615.333333,26667,17928,2779,47374,0
2393,15.14,5.0,64.0,1382.75,18608,24268,1478,44354,0
2394,34.9090566,5.603773585,104.2264151,1805.924528,35552,6738,1599,43889,1
2395,59.0,7.0,166.0,1798.0,30124,11395,2315,43834,0
2396,20.43008333,4.791666667,69.875,1773.0,33939,8104,1753,43796,0
2397,47.361875,3.75,113.375,1774.8125,30743,10314,2298,43355,1
2398,52.95719388,5.653061224,146.122449,2031.469388,33386,6522,2374,42282,0
2399,27.4386,6.34,85.28,1452.0,27445,12064,1715,41224,1
2400,113.2693333,8.0,246.3333333,2994.666667,29907,9201,1736,40844,1
2401,77.41666667,7.0,188.3333333,2876.0,27004,11488,2190,40682,1
2402,8.17,5.0,40.0,1108.0,12689,24311,2018,39018,0
2403,22.77681818,5.272727273,92.36363636,1837.363636,24058,13331,1568,38957,0
2404,61.86283333,6.833333333,184.1666667,2748.333333,16624,19175,2805,38604,0
2405,10.83275,5.0,45.0,1242.0,18821,17757,1925,38503,0
2406,30.99513158,5.789473684,101.8947368,1905.631579,21996,14240,1459,37695,0
2407,45.6995,6.0,114.0,1854.2,24675,9585,2541,36801,1
2408,32.898125,5.333333333,116.2916667,2081.375,28304,6708,1786,36798,0
2409,29.26025,5.95,90.625,1462.3625,24510,10901,1181,36592,0
2410,17.03876744,5.302325581,73.48837209,1374.046512,16650,17667,1813,36130,0
2411,13.24516667,4.833333333,66.66666667,1506.5,17102,15239,2089,34430,0
2412,9.8628,5.0,50.0,1090.4,16543,14924,2399,33866,0
2413,10.42388889,5.0,52.44444444,1095.777778,14514,17706,1614,33834,0
2414,34.19,6.0,103.0,1794.0,21284,10819,1612,33715,0
2415,16.59192308,5.0,52.84615385,998.0,11605,20235,1433,33273,0
2416,22.69,4.8,82.2,1773.7,23687,7848,1703,33238,0
2417,37.00904545,4.590909091,114.6818182,2208.090909,23011,7967,2136,33114,0
2418,38.72769231,5.538461538,114.6538462,2178.192308,25918,5123,1079,32120,1
2419,39.70773684,4.842105263,117.5789474,2719.842105,20353,9703,1544,31600,1
2420,20.7195,4.71875,81.375,1950.90625,23231,6625,1595,31451,0
2421,32.98557692,6.230769231,94.03846154,1528.807692,18478,11085,1875,31438,1
2422,36.38445588,4.5,125.7058824,2294.764706,24269,5423,1583,31275,0
2423,52.085,8.0,223.8333333,1969.0,24650,4351,1531,30532,0
2424,158.7922667,7.466666667,293.5333333,3005.4,25787,2824,1325,29936,0
2425,9.5628,4.6,50.0,996.0,11767,15393,2721,29881,0
2426,11.14333333,5.0,50.0,998.0,8939,18643,1203,28785,0
2427,22.95871429,6.285714286,80.0,998.0,16872,10525,1024,28421,0
2428,30.236875,4.5,110.0,2316.0,21369,5091,1404,27864,0
2429,43.08,4.666666667,105.0,2239.666667,18059,7327,1955,27341,0
2430,22.455,6.0,92.30769231,1466.307692,14819,10940,1442,27201,0
2431,25.94322222,4.777777778,67.0,1372.666667,11373,13390,2122,26885,0
2432,13.88308333,4.75,47.75,1373.75,8129,17108,1599,26836,0
2433,20.27896296,4.111111111,72.85185185,1832.888889,17668,7361,1345,26374,0
2434,11.389,4.142857143,53.0,1308.285714,9859,14793,1506,26158,0
2435,15.20916667,5.0,53.0,998.0,8260,15378,2161,25799,0
2436,83.50125,6.5,213.5,3071.0,18281,5631,1461,25373,0
2437,18.2955625,4.875,70.25,1836.5,20722,3377,648,24747,0
2438,36.64326667,4.466666667,88.73333333,2284.133333,18595,4269,1264,24128,0
2439,25.3433871,5.193548387,95.09677419,1802.774194,14273,8372,1284,23929,0
2440,32.09,4.0,98.2,1754.4,10760,11610,1371,23741,0
2441,27.09825,4.666666667,91.75,2247.333333,18500,4165,1049,23714,0
2442,115.533,8.0,250.0,2998.0,20026,2131,1231,23388,0
2443,37.01736842,4.736842105,97.57894737,2697.368421,16607,5830,908,23345,1
2444,19.45142857,3.571428571,61.0,1197.0,10730,10689,1898,23317,0
2445,7.92,4.0,33.33333333,868.3333333,11509,10686,1023,23218,0
2446,43.06842105,6.254385965,104.2017544,2222.710526,19061,2103,1523,22687,1
2447,49.82277778,6.0,115.8333333,1746.944444,14930,6226,1269,22425,0
2448,7.712,5.0,29.0,899.0,9224,11811,1202,22237,0
2449,44.14181818,6.545454545,144.6363636,2242.636364,14235,5973,639,20847,1
2450,145.6466667,6.0,283.0,5000.0,16780,2775,960,20515,0
2451,85.82946154,8.0,213.1538462,1969.0,13270,5918,1320,20508,0
2452,37.52210345,3.896551724,107.3793103,2084.37931,14633,4572,1269,20474,0
2453,39.7374,4.6,115.0,2234.4,10701,7912,1286,19899,0
2454,13.48615385,5.0,52.38461538,1028.923077,7490,11586,688,19764,0
2455,50.94,6.266666667,138.2833333,1986.766667,16239,2304,1118,19661,1
2456,29.88478947,4.736842105,109.1052632,2238.631579,11327,7218,973,19518,0
2457,43.97,6.6,115.3,1634.2,11678,6491,680,18849,1
2458,30.99,0.0,105.0,335.0,14388,3868,548,18804,0
2459,76.5922,8.0,184.0,2396.4,10478,7065,938,18481,0
2460,51.646,0.0,110.0,1995.0,11900,4855,1243,17998,0
2461,36.01325,6.0,151.6666667,2048.666667,13181,4266,483,17930,0
2462,20.1241875,4.875,79.875,1836.875,12227,4330,875,17432,0
2463,62.39565385,4.384615385,135.5,2972.307692,13459,2860,966,17285,0
2464,23.0525,5.0,55.0,1406.0,7561,8527,1196,17284,0
2465,42.74666667,5.0,128.5,2548.833333,14479,2287,513,17279,0
2466,17.82333333,4.666666667,70.33333333,1298.666667,8225,8111,808,17144,0
2467,135.1055,6.5,309.0,3999.0,14801,1679,598,17078,0
2468,13.70454545,4.818181818,47.45454545,1384.0,5684,10136,836,16656,0
2469,18.76848837,4.860465116,67.02325581,1391.023256,9828,5872,908,16608,1
2470,41.616,4.6,125.36,2336.52,12981,2662,952,16595,0
2471,64.109625,6.75,202.125,2778.0,10351,5074,1071,16496,0
2472,21.6,6.0,64.625,1496.0,7519,8205,709,16433,0
2473,19.31857143,5.0,66.42857143,1348.285714,8368,5438,2422,16228,1
2474,23.16515789,3.947368421,82.15789474,1817.315789,9676,5681,696,16053,0
2475,16.4455,4.666666667,78.0,1741.0,10484,4640,777,15901,0
2476,25.2075,5.0,80.5,1753.0,8591,5599,880,15070,0
2477,18.513,4.6,76.0,1599.0,9406,5223,416,15045,0
2478,32.723,3.6,96.0,1498.0,7885,6233,846,14964,0
2479,20.37,5.642857143,74.21428571,1324.357143,11214,3132,564,14910,0
2480,264.675,7.0,420.0,6208.0,10975,3058,803,14836,0
2481,16.29053333,4.8,57.86666667,1645.133333,9698,4324,707,14729,0
2482,26.0,5.0,70.0,1597.0,2032,11784,759,14575,0
2483,29.151,5.0,89.0,2526.5,10302,3598,581,14481,0
2484,31.195,6.0,105.875,1755.75,10007,4030,389,14426,0
2485,36.52419118,5.176470588,113.3529412,2106.5,9440,3589,820,13849,0
2486,26.97346154,3.076923077,85.69230769,1515.282051,8589,4511,745,13845,0
2487,52.19640625,5.3125,126.5,2323.9375,8806,3959,717,13482,0
2488,20.36464286,5.857142857,82.25,1534.392857,8761,3930,569,13260,1
2489,19.71783333,4.0,98.0,1995.0,8413,4072,756,13241,0
2490,23.01661538,4.730769231,90.88461538,1709.538462,9536,2740,426,12702,0
2491,33.798,0.0,96.0,1797.4,8064,3225,1399,12688,0
2492,27.13,5.768421053,96.05263158,1774.778947,7523,4235,388,12146,1
2493,30.86290909,4.454545455,105.5454545,2458.909091,10072,1612,407,12091,0
2494,27.78966667,4.666666667,110.6666667,2050.333333,8551,2713,579,11843,0
2495,23.16515789,3.947368421,82.15789474,1817.315789,7626,3449,766,11841,0
2496,32.11766667,4.666666667,115.3333333,2362.0,8692,2542,507,11741,0
2497,9.492272727,4.909090909,40.81818182,850.2727273,4221,6894,618,11733,0
2498,26.19775,4.625,77.0,1495.0,5462,5543,547,11552,0
2499,25.17006452,5.516129032,79.30645161,1523.741935,8301,2782,415,11498,1
2500,41.59161538,6.461538462,111.3076923,1624.769231,7532,3614,303,11449,0
2501,13.2053,6.0,35.8,679.0,4966,5671,672,11309,0
2502,22.95383333,5.0,67.33333333,1908.166667,7590,3039,668,11297,0
2503,46.5274,7.04,131.6,1596.92,9600,1227,446,11273,0
2504,14.333375,4.5625,59.875,1183.25,4725,5861,542,11128,0
2505,18.84548718,4.076923077,87.07692308,2326.358974,9372,1363,325,11060,0
2506,18.88233333,4.666666667,74.0,1523.333333,6689,3542,590,10821,0
2507,25.08266667,4.533333333,93.6,2127.333333,8511,1754,462,10727,0
2508,17.587,4.083333333,73.08333333,1363.5,6186,3507,570,10263,0
2509,94.098125,8.0,190.0,2967.0,7043,2431,380,9854,1
2510,41.38957143,7.285714286,105.7142857,1545.428571,5397,3935,475,9807,1
2511,34.93603125,5.25,97.71875,1820.65625,6019,3434,267,9720,1
2512,14.350125,4.875,59.5,1642.875,6677,2584,393,9654,0
2513,12.47666667,4.666666667,58.66666667,1498.0,5683,3397,520,9600,0
2514,36.70125,4.875,91.75,2019.75,6435,2570,490,9495,0
2515,17.31241935,4.967741935,66.35483871,1655.741935,6050,2935,478,9463,0
2516,14.7754,4.8,51.4,1428.4,4128,4473,533,9134,0
2517,14.22409091,4.727272727,64.45454545,1353.363636,4554,4088,446,9088,0
2518,47.52333333,6.0,128.8888889,1886.555556,5753,2884,308,8945,1
2519,23.22409091,4.909090909,82.0,1938.0,5467,2940,420,8827,0
2520,108.7471951,7.853658537,207.6097561,2304.97561,6755,1504,476,8735,1
2521,31.30566667,6.259259259,96.92592593,1587.222222,6618,1752,334,8704,0
2522,30.352,4.4,99.0,2117.6,5623,2726,344,8693,0
2523,53.792,6.0,134.3333333,1730.0,7408,879,363,8650,0
2524,9.358333333,4.333333333,47.0,1324.0,3952,3924,417,8293,0
2525,15.40377778,5.0,60.11111111,1593.111111,6164,1719,256,8139,0
2526,25.29875,4.5,94.0,1998.0,5198,2339,592,8129,0
2527,11.74,5.0,63.0,1405.0,3478,4074,558,8110,0
2528,114.8758333,8.0,235.0,2979.0,6642,1113,318,8073,0
2529,158.976,8.0,326.0,3295.0,5693,1861,342,7896,0
2530,29.57028571,5.0,84.0,1997.142857,5359,2069,450,7878,1
2531,33.12857143,5.285714286,103.0,1914.714286,4474,2933,392,7799,0
2532,24.674,0.0,60.0,160.0,3237,4021,448,7706,0
2533,14.4382,4.9,64.2,1891.7,5814,1636,228,7678,0
2534,45.59125,5.25,104.1666667,2027.833333,4816,2503,350,7669,0
2535,30.0062,3.2,115.4666667,2245.6,5948,1194,414,7556,0
2536,39.725,6.8,110.0,1592.0,6428,823,231,7482,0
2537,45.76307692,5.307692308,109.0769231,2053.0,4770,2275,432,7477,1
2538,15.16166667,4.666666667,75.0,1594.0,4988,2154,324,7466,0
2539,116.545,8.0,230.0,2981.0,6409,482,333,7224,0
2540,16.67175,4.5,74.0,1541.5,4456,2318,404,7178,0
2541,55.25,6.0,177.0,1997.0,5150,1576,396,7122,0
2542,22.12540909,5.5,75.09090909,1622.681818,4121,2695,292,7108,0
2543,23.245,4.5,98.0,1998.0,5266,1451,365,7082,0
2544,24.84,5.0,102.0,2244.0,5274,1375,293,6942,0
2545,11.28285714,4.285714286,49.28571429,1337.714286,3744,2679,331,6754,0
2546,22.127,5.0,83.0,1721.5,3656,2673,377,6706,0
2547,18.76285714,4.714285714,80.42857143,1612.928571,4509,1902,269,6680,0
2548,20.74,5.0,75.0,1695.0,3375,2897,277,6549,0
2549,19.9680625,2.8125,55.375,592.5625,3055,3148,298,6501,0
2550,20.49710714,4.142857143,72.42857143,1824.428571,4515,1605,305,6425,0
2551,58.46907407,6.444444444,148.5185185,2174.037037,4601,1289,446,6336,1
2552,31.7425,4.833333333,119.6666667,2116.0,4555,1152,244,5951,0
2553,18.657,5.0,59.58333333,1407.333333,2923,2753,272,5948,0
2554,7.863333333,5.0,44.0,1289.0,3978,1730,231,5939,0
2555,36.90769355,4.5,126.1451613,2344.0,4759,869,282,5910,0
2556,55.4225,6.0,221.0,3498.0,4833,816,260,5909,0
2557,42.2862,6.0,113.8,1740.0,2473,2986,441,5900,0
2558,20.6695,4.75,88.0,1586.0,3361,2159,365,5885,0
2559,24.35,6.0,60.0,698.0,3305,2117,354,5776,0
2560,107.6705126,8.277310924,196.3361345,2521.092437,5120,477,148,5745,1
2561,37.32636,4.76,101.12,2349.08,4474,892,270,5636,0
2562,285.247,7.2,428.2,5577.8,4921,482,216,5619,0
2563,12.49833333,5.0,48.66666667,1336.666667,2021,3295,299,5615,0
2564,60.87,6.75,228.0,1984.0,4529,838,219,5586,0
2565,40.7645,4.333333333,133.3333333,2634.222222,4283,906,301,5490,0
2566,48.09553571,5.107142857,117.7857143,2315.0,4599,634,238,5471,0
2567,19.055,4.6,89.2,1827.8,3799,1216,168,5183,0
2568,18.16715385,4.692307692,70.30769231,1932.153846,3637,1225,281,5143,0
2569,106.5488889,8.0,210.0,2976.333333,3799,1089,167,5055,1
2570,81.295,8.0,250.0,2998.0,4290,531,172,4993,0
2571,59.4905,5.0,137.5,2734.5,4240,536,174,4950,0
2572,19.895,4.8,94.0,1742.6,3341,1441,162,4944,0
2573,43.9745,4.5,98.0,2309.0,3121,1520,275,4916,0
2574,13.191,5.0,51.33333333,1431.333333,1961,2653,269,4883,0
2575,76.71,0.0,336.0,0.0,3681,879,193,4753,0
2576,23.585,5.8125,80.8125,1446.125,2899,1567,233,4699,1
2577,35.34,5.0,118.0,1781.0,3971,545,181,4697,0
2578,28.9602,4.4,100.8,1936.6,3576,864,230,4670,0
2579,38.48247059,4.882352941,90.94117647,2953.588235,3708,717,186,4611,1
2580,11.7129,4.0,69.0,1864.8,3837,532,99,4468,0
2581,55.2,6.0,163.5,2696.5,3025,1148,281,4454,0
2582,35.86943902,5.585365854,117.0243902,1980.634146,3669,572,173,4414,0
2583,60.9552,5.5,146.0,2588.6,2894,925,423,4242,1
2584,14.76166667,4.666666667,75.0,1594.0,2597,1384,178,4159,0
2585,70.31925,4.5,199.0,4123.5,3662,386,95,4143,0
2586,16.80266667,4.5,71.0,1764.0,2967,882,177,4026,0
2587,27.935,5.0,103.5,1833.0,2421,1298,306,4025,0
2588,37.44666667,2.611111111,120.3333333,2085.055556,2606,1094,190,3890,0
2589,95.29916667,6.333333333,253.6666667,3764.333333,3185,463,163,3811,0
2590,30.081,4.0,110.0,2254.0,2492,995,306,3793,0
2591,37.350625,5.375,121.0625,1972.8125,2891,722,165,3778,0
2592,44.62833333,4.333333333,127.6666667,3100.333333,2900,774,78,3752,1
2593,11.745,5.0,51.0,998.0,1742,1723,254,3719,0
2594,56.15916667,5.5,174.3333333,3199.0,2309,1234,158,3701,0
2595,26.59125,4.125,108.625,1911.75,2530,1100,70,3700,0
2596,26.97522727,5.863636364,88.09090909,1460.795455,2577,1045,78,3700,0
2597,18.19842857,5.0,87.71428571,1696.428571,2599,846,185,3630,0
2598,28.803,4.8,111.2,2126.8,2797,583,113,3493,0
2599,46.60136364,6.0,110.0,2393.0,2814,506,152,3472,1
2600,134.789,8.0,390.0,4395.0,3125,195,134,3454,0
2601,57.22905851,5.234042553,120.4255319,2309.340426,2384,727,235,3346,1
2602,84.60125,6.5,220.5,3071.0,2722,479,136,3337,0
2603,20.31264706,5.352941176,63.29411765,1344.823529,1820,1363,135,3318,1
2604,34.10357143,4.571428571,121.8571429,2555.285714,2534,426,167,3127,0
2605,33.70615385,6.153846154,120.1538462,1750.615385,2354,615,146,3115,0
2606,20.9225,5.375,68.875,1272.4375,1920,992,118,3030,0
2607,20.20388889,4.777777778,82.33333333,1775.777778,1821,983,138,2942,0
2608,121.77,6.666666667,316.3333333,3740.0,2578,232,113,2923,0
2609,20.35378947,4.789473684,67.68421053,1996.684211,2240,528,142,2910,0
2610,31.79107143,4.571428571,104.1428571,2211.071429,2221,451,115,2787,0
2611,32.4898913,5.304347826,113.2826087,2093.021739,1464,1059,193,2716,0
2612,17.42714286,5.0,87.71428571,1696.428571,1881,706,126,2713,0
2613,69.397,5.0,173.0,3358.666667,2266,310,137,2713,0
2614,273.755,6.0,381.0,5935.0,2423,183,79,2685,0
2615,30.92666667,4.666666667,110.3333333,2328.333333,1862,581,136,2579,0
2616,54.2675,5.666666667,114.0,1998.0,1852,602,95,2549,1
2617,53.62733333,0.0,122.6666667,2331.333333,1830,551,167,2548,0
2618,360.755,6.0,410.0,5341.0,2289,148,67,2504,0
2619,30.839,4.6,121.0,2378.0,1593,773,138,2504,0
2620,158.823,4.5,250.0,3228.0,2142,185,107,2434,0
2621,36.35965,4.55,110.5,2345.1,1990,268,116,2374,0
2622,38.025,4.5,129.5,2614.0,1481,733,106,2320,0
2623,13.382,2.5,48.0,1343.0,703,1362,135,2200,0
2624,43.89111111,5.666666667,130.5555556,2457.555556,1850,244,103,2197,0
2625,28.96891667,5.0,72.625,1707.125,1319,701,162,2182,0
2626,17.5296,4.6,78.4,1549.8,1760,337,69,2166,0
2627,32.1815,6.0,99.0,1448.6,1430,653,47,2130,0
2628,38.79428571,4.428571429,98.57142857,2755.571429,1657,360,82,2099,1
2629,45.78386047,4.813953488,106.3023256,2768.511628,1462,389,93,1944,1
2630,15.764,5.0,66.0,1497.0,944,847,115,1906,0
2631,21.407,4.5,72.0,1974.0,1296,488,91,1875,0
2632,23.16515789,3.947368421,82.15789474,1817.315789,1019,532,89,1640,0
2633,17.91985714,4.19047619,64.47619048,1759.190476,1217,338,69,1624,0
2634,8.4656,4.6,41.4,1182.4,1277,257,44,1578,0
2635,23.8115,5.0,64.0,1298.0,439,1033,105,1577,0
2636,87.487,0.0,188.0,3498.0,1055,412,74,1541,0
2637,12.924,4.0,43.0,989.0,674,752,111,1537,0
2638,646.605,6.0,450.0,5733.0,1350,132,54,1536,0
2639,43.26150943,5.905660377,135.3773585,2276.0,1274,189,71,1534,1
2640,111.993,5.0,220.0,4988.0,1303,134,53,1490,0
2641,35.29583333,5.0,102.0,2129.0,897,477,86,1460,0
2642,57.22905851,5.234042553,120.4255319,2309.340426,1105,269,86,1460,1
2643,88.77777778,7.0,190.0,3377.444444,1048,320,66,1434,0
2644,28.735,4.666666667,100.6666667,1590.0,916,441,59,1416,0
2645,110.0985,5.0,235.0,4957.0,1249,79,65,1393,0
2646,32.33086957,5.891304348,103.1086957,1482.5,867,447,57,1371,0
2647,12.25,5.0,43.0,1325.0,958,311,52,1321,0
2648,21.91166667,4.666666667,88.0,1586.0,702,522,49,1273,0
2649,59.43242424,7.0,150.4545455,1981.818182,1068,141,49,1258,0
2650,35.27,6.0,112.0714286,1574.428571,762,389,102,1253,0
2651,23.90933333,5.0,100.6666667,2016.777778,1038,158,38,1234,0
2652,93.42433333,5.0,233.0,2995.0,1109,39,31,1179,0
2653,107.7,5.0,274.0,3800.5,1054,88,35,1177,0
2654,28.295,5.0,96.0,1747.0,805,310,61,1176,0
2655,28.379,4.6,91.6,2181.2,933,186,37,1156,0
2656,28.60918919,5.945945946,100.5945946,1387.621622,753,361,24,1138,0
2657,51.6415625,5.375,126.5,2376.75,932,148,52,1132,0
2658,200.19825,6.0,294.0,3586.0,971,69,47,1087,0
2659,88.46428571,0.0,230.0,3456.0,730,302,55,1087,0
2660,34.33029412,5.588235294,105.0,1962.058824,838,215,25,1078,1
2661,74.609,3.2,239.2,3640.2,952,96,19,1067,0
2662,13.137,5.0,93.5,1998.0,911,105,42,1058,0
2663,260.287,6.0,360.0,4308.0,962,30,26,1018,0
2664,18.53214286,5.714285714,68.57142857,1166.142857,521327,583473,47501,1152301,0
2665,30.61932203,5.966101695,94.03389831,1497.169492,517435,268674,32498,818607,0
2666,39.97375,1.75,130.25,1998.5,571242,129396,25764,726402,0
2667,31.24215385,6.164835165,89.46153846,1537.406593,402833,259643,41756,704232,0
2668,22.1,5.615384615,75.57692308,1219.653846,268057,388605,31846,688508,0
2669,20.03375,4.833333333,71.33333333,1631.5,191616,330591,27359,549566,0
2670,20.3776087,4.869565217,67.95652174,1279.695652,190596,321693,31312,543601,0
2671,47.84837037,6.444444444,126.1111111,1995.777778,376417,129396,28569,534382,0
2672,16.20874359,4.461538462,63.56410256,1650.205128,346953,155085,21131,523169,0
2673,26.4498867,5.408866995,87.31034483,1623.793103,276433,204160,26127,506720,0
2674,18.1925,5.074074074,60.96296296,1408.055556,186844,273400,30912,491156,0
2675,15.46,5.0,60.8,1196.0,98363,277050,19341,394754,0
2676,29.942625,4.5,106.225,1480.575,229537,134955,21478,385970,0
2677,18.64264,4.84,67.0,1698.64,188716,113999,15097,317812,0
2678,17.182,5.0,74.0,1994.0,170493,102738,13104,286335,0
2679,12.35588235,4.647058824,53.88235294,1366.294118,114308,146293,12753,273354,0
2680,22.36209302,4.88372093,72.58139535,1743.44186,164658,88629,9990,263277,0
2681,27.23911864,3.033898305,91.61016949,1677.949153,141093,88669,15081,244843,0
2682,46.06451282,6.487179487,125.4358974,1835.846154,176991,41204,12713,230908,0
2683,34.02059211,5.552631579,99.0,1920.026316,169766,46326,9715,225807,1
2684,46.5274,7.04,131.6,1596.92,155484,50942,14625,221051,0
2685,20.7206,3.52,74.4,1397.8,74699,129009,17095,220803,0
2686,27.46483636,4.872727273,86.45454545,1723.0,116090,86600,9319,212009,0
2687,12.32981818,4.818181818,53.81818182,1367.272727,88989,107919,8348,205256,0
2688,57.92693548,6.161290323,149.7096774,2283.112903,151298,42386,10623,204307,0
2689,28.60820513,4.756410256,92.82051282,2043.820513,158601,33953,9517,202071,0
2690,22.78208333,4.916666667,81.66666667,1847.666667,120798,67882,9495,198175,0
2691,26.51269565,4.02173913,93.58695652,1933.021739,125527,34020,8721,168268,0
2692,107.4521429,8.0,182.5714286,2425.428571,124699,33003,6639,164341,1
2693,93.71425,8.0,225.0,2979.0,134477,20989,8288,163754,0
2694,43.86363077,5.292307692,105.1692308,2083.523077,89396,51392,6908,147696,1
2695,37.31523077,4.323076923,103.6769231,1873.261538,107967,25770,8385,142122,0
2696,39.39984314,5.784313725,117.7058824,2151.647059,105231,23582,8260,137073,0
2697,78.07322727,7.672727273,192.4,2598.818182,98801,17562,8030,124393,0
2698,31.38814286,6.714285714,111.0,1711.571429,44843,68277,7273,120393,0
2699,19.00794118,5.205882353,66.97058824,1292.352941,61976,46584,5535,114095,0
2700,36.21929825,6.473684211,94.33333333,1424.666667,60149,37164,6552,103865,0
2701,43.54851613,1.35483871,137.7741935,2261.193548,46265,49846,7288,103399,0
2702,26.3525,0.0,80.0,1498.0,43161,52352,4898,100411,0
2703,19.93814035,5.649122807,76.31578947,1205.192982,47581,46648,4556,98785,0
2704,53.78571429,6.0,124.8571429,1855.0,63584,27101,4599,95284,1
2705,22.90364865,5.405405405,75.64864865,1364.0,38708,51066,3948,93722,0
2706,31.1045119,4.547619048,93.01190476,1699.119048,37792,48472,7108,93372,0
2707,39.35238095,5.0,98.04761905,1928.714286,74373,12412,3244,90029,0
2708,26.803,5.428571429,85.71428571,1310.0,44347,32723,5110,82180,0
2709,17.34364706,4.745098039,70.92156863,1683.607843,47051,30649,4395,82095,0
2710,17.44569231,4.692307692,68.26923077,1791.230769,59916,16630,4932,81478,0
2711,30.65053846,6.346153846,95.0,1136.692308,60636,14068,3429,78133,0
2712,37.46857143,5.857142857,103.4285714,1718.571429,34296,38297,5120,77713,0
2713,49.28583333,6.0,145.0,1963.666667,52501,18611,4678,75790,0
2714,13.11525,4.75,50.875,1430.75,40279,28509,3609,72397,0
2715,14.293,4.6,75.4,1479.0,39426,28912,3527,71865,0
2716,50.96109091,6.181818182,135.2909091,1971.163636,53947,13142,4573,71662,1
2717,107.6705126,8.277310924,196.3361345,2521.092437,56469,11535,2513,70517,1
2718,24.84390244,4.756097561,84.92682927,1982.756098,53134,12585,3057,68776,0
2719,35.28132353,5.176470588,113.3529412,2106.5,48858,15522,3826,68206,0
2720,82.06090909,7.727272727,199.7272727,2790.454545,54133,10063,3715,67911,1
2721,23.322,3.75,84.2,1853.9,48949,15059,2338,66346,0
2722,16.05676923,4.923076923,67.0,1703.153846,41342,21205,3380,65927,0
2723,65.56875,8.0,167.25,1998.0,52203,10223,2522,64948,0
2724,20.43008333,4.791666667,69.875,1773.0,47305,11800,2469,61574,0
2725,35.81481651,6.293577982,117.4311927,1921.46789,40131,16752,3647,60530,0
2726,11.370625,5.0,48.0,1518.0,34679,21426,2958,59063,0
2727,33.25025,6.166666667,112.75,1475.0,17071,37454,3814,58339,0
2728,24.09525,6.25,68.75,1498.25,16600,37984,3481,58065,0
2729,17.22277778,4.888888889,70.0,1615.333333,31516,21372,3199,56087,0
2730,32.06304348,5.956521739,89.34782609,1472.826087,33327,19917,2297,55541,1
2731,31.5255,5.166666667,109.6666667,1861.833333,36236,15152,2850,54238,0
2732,10.83275,5.0,45.0,1242.0,25264,25247,2692,53203,0
2733,32.93965169,6.348314607,114.8202247,1615.370787,35173,13894,2426,51493,0
2734,72.79589474,6.210526316,166.3157895,3041.0,33735,14450,3109,51294,0
2735,137.5695455,8.0,223.5454545,2813.0,44277,4346,2042,50665,0
2736,30.3775,6.3125,94.0625,935.625,17179,29648,2976,49803,0
2737,21.02333333,5.0,92.33333333,1729.333333,28381,18426,1672,48479,0
2738,30.5976,1.8,97.6,1757.6,37458,8408,1945,47811,0
2739,66.58842105,5.736842105,172.3157895,2934.631579,39464,5484,1945,46893,0
2740,25.39952941,4.647058824,78.85294118,1891.588235,33683,10568,2155,46406,0
2741,59.0,7.0,166.0,1798.0,32022,11965,2409,46396,0
2742,64.59222222,6.777777778,178.5555556,2011.555556,26441,16736,3059,46236,0
2743,19.08518182,3.727272727,68.90909091,1180.545455,20500,22021,3562,46083,0
2744,19.37890909,4.863636364,61.27272727,1470.909091,25733,18368,1398,45499,0
2745,42.66935185,5.907407407,118.1851852,2095.185185,33926,8089,1605,43620,0
2746,13.63642857,4.714285714,69.0,1424.857143,20415,21805,1318,43538,0
2747,34.9090566,5.603773585,104.2264151,1805.924528,33870,6282,1483,41635,1
2748,8.17,5.0,40.0,1108.0,12639,25710,2081,40430,0
2749,52.95719388,5.653061224,146.122449,2031.469388,31247,5941,2291,39479,0
2750,18.2955625,4.875,70.25,1836.5,32143,5722,1031,38896,0
2751,22.77681818,5.272727273,92.36363636,1837.363636,23693,12797,1418,37908,0
2752,32.898125,5.333333333,116.2916667,2081.375,29003,7068,1814,37885,0
2753,27.4386,6.34,85.28,1452.0,25366,10982,1492,37840,1
2754,37.00904545,4.590909091,114.6818182,2208.090909,26265,9162,2408,37835,0
2755,15.14,5.0,64.0,1382.75,16253,20171,1198,37622,0
2756,13.24516667,4.833333333,66.66666667,1506.5,18666,16571,2232,37469,0
2757,20.7195,4.71875,81.375,1950.90625,27682,7764,1823,37269,0
2758,77.41666667,7.0,188.3333333,2876.0,24135,10352,2029,36516,1
2759,20.27896296,4.111111111,72.85185185,1832.888889,24375,10206,1882,36463,0
2760,47.361875,3.75,113.375,1774.8125,25652,8519,2033,36204,1
2761,113.2693333,8.0,246.3333333,2994.666667,26292,7930,1511,35733,1
2762,22.69,4.8,82.2,1773.7,25319,8446,1783,35548,0
2763,34.19,6.0,103.0,1794.0,22476,11228,1737,35441,0
2764,61.86283333,6.833333333,184.1666667,2748.333333,15544,17004,2654,35202,0
2765,45.6995,6.0,114.0,1854.2,23190,9378,2343,34911,1
2766,36.38445588,4.5,125.7058824,2294.764706,26529,6048,1737,34314,0
2767,9.8628,5.0,50.0,1090.4,16564,14380,2434,33378,0
2768,30.236875,4.5,110.0,2316.0,24542,5919,1656,32117,0
2769,37.4265,6.2,104.2,1796.6,16157,13599,1635,31391,0
2770,9.5628,4.6,50.0,996.0,12303,15404,2907,30614,0
2771,27.09825,4.666666667,91.75,2247.333333,23661,5569,1355,30585,0
2772,22.455,6.0,92.30769231,1466.307692,16350,12418,1644,30412,0
2773,17.03876744,5.302325581,73.48837209,1374.046512,14163,14561,1561,30285,0
2774,36.64326667,4.466666667,88.73333333,2284.133333,22477,5338,1535,29350,0
2775,39.70773684,4.842105263,117.5789474,2719.842105,18928,8936,1381,29245,1
2776,7.712,5.0,29.0,899.0,11125,15532,1508,28165,0
2777,43.08,4.666666667,105.0,2239.666667,18483,7532,1964,27979,0
2778,30.99513158,5.789473684,101.8947368,1905.631579,16450,10477,994,27921,0
2779,158.7922667,7.466666667,293.5333333,3005.4,24005,2572,1247,27824,0
2780,52.085,8.0,223.8333333,1969.0,22387,3869,1395,27651,0
2781,11.389,4.142857143,53.0,1308.285714,10078,15732,1562,27372,0
2782,13.88308333,4.75,47.75,1373.75,8047,17329,1599,26975,0
2783,10.42388889,5.0,52.44444444,1095.777778,11421,13812,1194,26427,0
2784,16.59192308,5.0,52.84615385,998.0,9225,15732,1061,26018,0
2785,7.92,4.0,33.33333333,868.3333333,12243,12277,1158,25678,0
2786,22.95871429,6.285714286,80.0,998.0,15355,9198,871,25424,0
2787,25.94322222,4.777777778,67.0,1372.666667,10319,12806,2090,25215,0
2788,115.533,8.0,250.0,2998.0,21013,2294,1238,24545,0
2789,83.50125,6.5,213.5,3071.0,17497,5056,1424,23977,0
2790,37.01736842,4.736842105,97.57894737,2697.368421,16840,6164,938,23942,1
2791,16.29053333,4.8,57.86666667,1645.133333,15799,6992,1112,23903,0
2792,32.09,4.0,98.2,1754.4,10541,11954,1298,23793,0
2793,25.3433871,5.193548387,95.09677419,1802.774194,13531,7992,1216,22739,0
2794,32.98557692,6.230769231,94.03846154,1528.807692,13219,7864,1356,22439,1
2795,19.45142857,3.571428571,61.0,1197.0,10118,9739,1833,21690,0
2796,29.26025,5.95,90.625,1462.3625,14544,6253,655,21452,0
2797,49.82277778,6.0,115.8333333,1746.944444,14182,5900,1308,21390,0
2798,41.616,4.6,125.36,2336.52,16533,3504,1180,21217,0
2799,38.72769231,5.538461538,114.6538462,2178.192308,17102,3393,699,21194,1
2800,37.52210345,3.896551724,107.3793103,2084.37931,15014,4798,1313,21125,0
2801,43.06842105,6.254385965,104.2017544,2222.710526,17659,1987,1453,21099,1
2802,20.1241875,4.875,79.875,1836.875,14322,5083,976,20381,0
2803,39.7374,4.6,115.0,2234.4,10775,8057,1288,20120,0
2804,62.39565385,4.384615385,135.5,2972.307692,15395,3320,1099,19814,0
2805,16.4455,4.666666667,78.0,1741.0,12489,5639,908,19036,0
2806,30.99,0.0,105.0,335.0,14481,3957,510,18948,0
2807,50.94,6.266666667,138.2833333,1986.766667,15331,2131,1019,18481,1
2808,145.6466667,6.0,283.0,5000.0,14848,2460,877,18185,0
2809,29.88478947,4.736842105,109.1052632,2238.631579,10612,6618,901,18131,0
2810,44.14181818,6.545454545,144.6363636,2242.636364,12350,5124,528,18002,1
2811,18.84548718,4.076923077,87.07692308,2326.358974,14509,2174,516,17199,0
2812,23.0525,5.0,55.0,1406.0,7549,8387,1158,17094,0
2813,42.74666667,5.0,128.5,2548.833333,14337,2194,483,17014,0
2814,135.1055,6.5,309.0,3999.0,14726,1673,609,17008,0
2815,13.70454545,4.818181818,47.45454545,1384.0,5873,10257,834,16964,0
2816,51.646,0.0,110.0,1995.0,11100,4503,1195,16798,0
2817,85.82946154,8.0,213.1538462,1969.0,10772,4786,1115,16673,0
2818,43.97,6.6,115.3,1634.2,10048,5685,588,16321,1
2819,23.16515789,3.947368421,82.15789474,1817.315789,9887,5509,646,16042,0
2820,20.37,5.642857143,74.21428571,1324.357143,12152,3320,566,16038,0
2821,30.86290909,4.454545455,105.5454545,2458.909091,12992,2058,536,15586,0
2822,29.151,5.0,89.0,2526.5,10873,3878,617,15368,0
2823,32.723,3.6,96.0,1498.0,8077,6451,828,15356,0
2824,14.350125,4.875,59.5,1642.875,10540,4130,613,15283,0
2825,36.01325,6.0,151.6666667,2048.666667,11266,3567,407,15240,0
2826,18.76848837,4.860465116,67.02325581,1391.023256,8884,5402,822,15108,1
2827,11.14333333,5.0,50.0,998.0,4737,9646,575,14958,0
2828,15.40377778,5.0,60.11111111,1593.111111,10975,3318,474,14767,0
2829,21.70216667,4.9,79.76666667,1536.0,6138,7975,529,14642,0
2830,19.71783333,4.0,98.0,1995.0,9335,4527,767,14629,0
2831,25.2075,5.0,80.5,1753.0,8468,5309,825,14602,0
2832,26.0,5.0,70.0,1597.0,2199,11665,642,14506,0
2833,12.47666667,4.666666667,58.66666667,1498.0,8289,5072,780,14141,0
2834,264.675,7.0,420.0,6208.0,10466,2888,776,14130,0
2835,27.78966667,4.666666667,110.6666667,2050.333333,10009,3217,721,13947,0
2836,17.82333333,4.666666667,70.33333333,1298.666667,6803,6487,630,13920,0
2837,23.16515789,3.947368421,82.15789474,1817.315789,8641,4020,888,13549,0
2838,18.513,4.6,76.0,1599.0,8475,4579,315,13369,0
2839,15.20916667,5.0,53.0,998.0,4359,7482,1064,12905,0
2840,22.95383333,5.0,67.33333333,1908.166667,8521,3504,713,12738,0
2841,25.08266667,4.533333333,93.6,2127.333333,9935,2089,519,12543,0
2842,64.109625,6.75,202.125,2778.0,7688,3850,860,12398,0
2843,31.195,6.0,105.875,1755.75,8558,3371,338,12267,0
2844,52.19640625,5.3125,126.5,2323.9375,8044,3548,630,12222,0
2845,76.5922,8.0,184.0,2396.4,6942,4558,649,12149,0
2846,32.11766667,4.666666667,115.3333333,2362.0,8924,2709,494,12127,0
2847,20.36464286,5.857142857,82.25,1534.392857,7911,3511,456,11878,1
2848,11.28285714,4.285714286,49.28571429,1337.714286,6300,4714,573,11587,0
2849,21.6,6.0,64.625,1496.0,5537,5609,440,11586,0
2850,14.4382,4.9,64.2,1891.7,8732,2483,369,11584,0
2851,17.587,4.083333333,73.08333333,1363.5,6771,3981,602,11354,0
2852,23.01661538,4.730769231,90.88461538,1709.538462,8364,2545,399,11308,0
2853,17.31241935,4.967741935,66.35483871,1655.741935,6903,3333,525,10761,0
2854,13.2053,6.0,35.8,679.0,4717,5178,628,10523,0
2855,9.358333333,4.333333333,47.0,1324.0,4963,5043,515,10521,0
2856,18.88233333,4.666666667,74.0,1523.333333,6499,3227,582,10308,0
2857,26.19775,4.625,77.0,1495.0,4820,4896,469,10185,0
2858,36.52419118,5.176470588,113.3529412,2106.5,6784,2519,571,9874,0
2859,16.67175,4.5,74.0,1541.5,5942,3103,573,9618,0
2860,25.17006452,5.516129032,79.30645161,1523.741935,6887,2388,302,9577,1
2861,36.70125,4.875,91.75,2019.75,6422,2540,508,9470,0
2862,14.7754,4.8,51.4,1428.4,4220,4577,520,9317,0
2863,14.333375,4.5625,59.875,1183.25,3834,4780,442,9056,0
2864,20.49710714,4.142857143,72.42857143,1824.428571,6249,2306,439,8994,0
2865,7.863333333,5.0,44.0,1289.0,5949,2664,376,8989,0
2866,30.0062,3.2,115.4666667,2245.6,7070,1443,469,8982,0
2867,23.22409091,4.909090909,82.0,1938.0,5588,2907,387,8882,0
2868,13.48615385,5.0,52.38461538,1028.923077,3451,5117,273,8841,0
2869,24.84,5.0,102.0,2244.0,6602,1790,370,8762,0
2870,53.792,6.0,134.3333333,1730.0,7401,860,359,8620,0
2871,30.352,4.4,99.0,2117.6,5587,2682,297,8566,0
2872,23.245,4.5,98.0,1998.0,6403,1722,417,8542,0
2873,41.59161538,6.461538462,111.3076923,1624.769231,5568,2590,200,8358,0
2874,25.29875,4.5,94.0,1998.0,5248,2428,596,8272,0
2875,11.74,5.0,63.0,1405.0,3642,4001,590,8233,0
2876,46.5274,7.04,131.6,1596.92,7074,834,308,8216,0
2877,29.57028571,5.0,84.0,1997.142857,5609,2129,454,8192,1
2878,15.16166667,4.666666667,75.0,1594.0,5330,2252,348,7930,0
2879,37.32636,4.76,101.12,2349.08,6161,1232,346,7739,0
2880,23.585,5.8125,80.8125,1446.125,4673,2651,391,7715,1
2881,107.6705126,8.277310924,196.3361345,2521.092437,6736,714,213,7663,1
2882,22.127,5.0,83.0,1721.5,4128,3091,430,7649,0
2883,94.098125,8.0,190.0,2967.0,5484,1858,290,7632,1
2884,33.798,0.0,96.0,1797.4,4981,1783,851,7615,0
2885,19.31857143,5.0,66.42857143,1348.285714,3775,2490,1222,7487,1
2886,27.13,5.768421053,96.05263158,1774.778947,4645,2454,283,7382,1
2887,108.7471951,7.853658537,207.6097561,2304.97561,5738,1244,392,7374,1
2888,9.492272727,4.909090909,40.81818182,850.2727273,2722,4107,299,7128,0
2889,114.8758333,8.0,235.0,2979.0,5615,881,270,6766,0
2890,158.976,8.0,326.0,3295.0,4819,1489,316,6624,0
2891,116.545,8.0,230.0,2981.0,5836,436,311,6583,0
2892,20.74,5.0,75.0,1695.0,3407,2892,278,6577,0
2893,55.25,6.0,177.0,1997.0,4732,1446,370,6548,0
2894,45.59125,5.25,104.1666667,2027.833333,4139,2088,285,6512,0
2895,18.16715385,4.692307692,70.30769231,1932.153846,4581,1526,311,6418,0
2896,39.725,6.8,110.0,1592.0,5491,675,245,6411,0
2897,24.674,0.0,60.0,160.0,2831,3199,367,6397,0
2898,31.7425,4.833333333,119.6666667,2116.0,4812,1185,244,6241,0
2899,36.90769355,4.5,126.1451613,2344.0,5046,890,300,6236,0
2900,16.80266667,4.5,71.0,1764.0,4587,1381,255,6223,0
2901,40.7645,4.333333333,133.3333333,2634.222222,4872,1011,327,6210,0
2902,45.76307692,5.307692308,109.0769231,2053.0,3892,1789,353,6034,1
2903,31.30566667,6.259259259,96.92592593,1587.222222,4496,1243,223,5962,0
2904,14.22409091,4.727272727,64.45454545,1353.363636,3011,2604,261,5876,0
2905,13.191,5.0,51.33333333,1431.333333,2236,3067,294,5597,0
2906,81.295,8.0,250.0,2998.0,4787,620,186,5593,0
2907,24.35,6.0,60.0,698.0,3209,2053,296,5558,0
2908,28.9602,4.4,100.8,1936.6,4216,1019,314,5549,0
2909,41.38957143,7.285714286,105.7142857,1545.428571,3162,2130,256,5548,1
2910,59.4905,5.0,137.5,2734.5,4626,641,218,5485,0
2911,33.12857143,5.285714286,103.0,1914.714286,3150,1903,253,5306,0
2912,35.34,5.0,118.0,1781.0,4437,632,211,5280,0
2913,35.86943902,5.585365854,117.0243902,1980.634146,4389,693,193,5275,0
2914,19.055,4.6,89.2,1827.8,3904,1191,153,5248,0
2915,43.9745,4.5,98.0,2309.0,3260,1623,294,5177,0
2916,76.71,0.0,336.0,0.0,3954,982,193,5129,0
2917,55.4225,6.0,221.0,3498.0,4165,700,246,5111,0
2918,14.76166667,4.666666667,75.0,1594.0,3098,1705,231,5034,0
2919,20.35378947,4.789473684,67.68421053,1996.684211,3792,970,251,5013,0
2920,11.7129,4.0,69.0,1864.8,4247,634,111,4992,0
2921,48.09553571,5.107142857,117.7857143,2315.0,4161,585,199,4945,0
2922,38.48247059,4.882352941,90.94117647,2953.588235,3954,776,181,4911,1
2923,58.46907407,6.444444444,148.5185185,2174.037037,3546,993,337,4876,1
2924,18.76285714,4.714285714,80.42857143,1612.928571,3194,1301,181,4676,0
2925,11.745,5.0,51.0,998.0,2045,2100,344,4489,0
2926,18.19842857,5.0,87.71428571,1696.428571,3148,1056,242,4446,0
2927,60.87,6.75,228.0,1984.0,3443,672,182,4297,0
2928,285.247,7.2,428.2,5577.8,3792,320,142,4254,0
2929,55.2,6.0,163.5,2696.5,2845,1151,246,4242,0
2930,22.12540909,5.5,75.09090909,1622.681818,2357,1456,171,3984,0
2931,27.935,5.0,103.5,1833.0,2410,1274,287,3971,0
2932,30.081,4.0,110.0,2254.0,2567,1038,290,3895,0
2933,19.895,4.8,94.0,1742.6,2692,1080,110,3882,0
2934,19.9680625,2.8125,55.375,592.5625,1691,1894,191,3776,0
2935,33.70615385,6.153846154,120.1538462,1750.615385,2848,751,171,3770,0
2936,31.79107143,4.571428571,104.1428571,2211.071429,3007,602,157,3766,0
2937,46.60136364,6.0,110.0,2393.0,3012,552,147,3711,1
2938,34.10357143,4.571428571,121.8571429,2555.285714,2925,518,203,3646,0
2939,18.657,5.0,59.58333333,1407.333333,1847,1590,145,3582,0
2940,95.29916667,6.333333333,253.6666667,3764.333333,2942,440,153,3535,0
2941,57.22905851,5.234042553,120.4255319,2309.340426,2459,746,235,3440,1
2942,44.62833333,4.333333333,127.6666667,3100.333333,2512,643,69,3224,1
2943,36.35965,4.55,110.5,2345.1,2696,360,164,3220,0
2944,17.42714286,5.0,87.71428571,1696.428571,2206,837,164,3207,0
2945,56.15916667,5.5,174.3333333,3199.0,2106,947,136,3189,0
2946,134.789,8.0,390.0,4395.0,2904,163,118,3185,0
2947,28.803,4.8,111.2,2126.8,2533,488,93,3114,0
2948,20.31264706,5.352941176,63.29411765,1344.823529,1677,1248,113,3038,1
2949,30.92666667,4.666666667,110.3333333,2328.333333,2152,712,151,3015,0
2950,60.9552,5.5,146.0,2588.6,1976,611,423,3010,1
2951,69.397,5.0,173.0,3358.666667,2471,377,150,2998,0
2952,47.52333333,6.0,128.8888889,1886.555556,1984,902,94,2980,1
2953,21.407,4.5,72.0,1974.0,1859,713,140,2712,0
2954,37.350625,5.375,121.0625,1972.8125,2033,506,123,2662,0
2955,17.91985714,4.19047619,64.47619048,1759.190476,1965,545,123,2633,0
2956,158.823,4.5,250.0,3228.0,2132,188,113,2433,0
2957,38.79428571,4.428571429,98.57142857,2755.571429,1894,439,93,2426,1
2958,12.49833333,5.0,48.66666667,1336.666667,828,1380,124,2332,0
2959,38.025,4.5,129.5,2614.0,1505,715,93,2313,0
2960,43.89111111,5.666666667,130.5555556,2457.555556,1934,252,117,2303,0
2961,13.382,2.5,48.0,1343.0,706,1391,129,2226,0
2962,37.44666667,2.611111111,120.3333333,2085.055556,1481,635,95,2211,0
2963,17.5296,4.6,78.4,1549.8,1734,392,74,2200,0
2964,20.20388889,4.777777778,82.33333333,1775.777778,1372,733,90,2195,0
2965,70.31925,4.5,199.0,4123.5,1869,205,45,2119,0
2966,8.4656,4.6,41.4,1182.4,1666,376,72,2114,0
2967,28.96891667,5.0,72.625,1707.125,1247,686,139,2072,0
2968,15.764,5.0,66.0,1497.0,1004,921,120,2045,0
2969,42.2862,6.0,113.8,1740.0,852,1009,159,2020,0
2970,53.62733333,0.0,122.6666667,2331.333333,1445,415,145,2005,0
2971,54.2675,5.666666667,114.0,1998.0,1481,458,58,1997,1
2972,30.839,4.6,121.0,2378.0,1305,580,103,1988,0
2973,273.755,6.0,381.0,5935.0,1790,140,56,1986,0
2974,45.78386047,4.813953488,106.3023256,2768.511628,1475,363,95,1933,1
2975,106.5488889,8.0,210.0,2976.333333,1436,373,63,1872,1
2976,20.6695,4.75,88.0,1586.0,1147,614,101,1862,0
2977,23.16515789,3.947368421,82.15789474,1817.315789,1149,601,99,1849,0
2978,84.60125,6.5,220.5,3071.0,1531,211,75,1817,0
2979,28.379,4.6,91.6,2181.2,1380,269,53,1702,0
2980,23.90933333,5.0,100.6666667,2016.777778,1422,211,62,1695,0
2981,26.59125,4.125,108.625,1911.75,1199,462,31,1692,0
2982,12.924,4.0,43.0,989.0,664,839,115,1618,0
2983,121.77,6.666666667,316.3333333,3740.0,1450,97,69,1616,0
2984,12.25,5.0,43.0,1325.0,1131,411,53,1595,0
2985,111.993,5.0,220.0,4988.0,1369,151,65,1585,0
2986,646.605,6.0,450.0,5733.0,1389,128,60,1577,0
2987,360.755,6.0,410.0,5341.0,1455,69,33,1557,0
2988,28.735,4.666666667,100.6666667,1590.0,973,490,79,1542,0
2989,110.0985,5.0,235.0,4957.0,1343,82,69,1494,0
2990,35.29583333,5.0,102.0,2129.0,876,473,75,1424,0
2991,28.295,5.0,96.0,1747.0,884,370,70,1324,0
2992,87.487,0.0,188.0,3498.0,871,317,72,1260,0
2993,35.27,6.0,112.0714286,1574.428571,759,381,116,1256,0
2994,23.8115,5.0,64.0,1298.0,371,801,82,1254,0
2995,10.32442857,4.142857143,54.35714286,1463.857143,704,462,53,1219,0
2996,107.7,5.0,274.0,3800.5,1092,89,38,1219,0
2997,93.42433333,5.0,233.0,2995.0,1144,38,24,1206,0
2998,35.25972727,4.727272727,104.6363636,2367.181818,987,163,53,1203,0
2999,22.35277778,4.222222222,80.92592593,1977.259259,939,183,43,1165,0
3000,200.19825,6.0,294.0,3586.0,1056,56,39,1151,0
3001,51.6415625,5.375,126.5,2376.75,911,154,50,1115,0
3002,38.39725,4.75,131.0,2652.375,968,105,39,1112,0
3003,13.137,5.0,93.5,1998.0,956,108,45,1109,0
3004,57.22905851,5.234042553,120.4255319,2309.340426,777,207,66,1050,1
3005,18.53214286,5.714285714,68.57142857,1166.142857,544298,601918,49080,1195296,0
3006,39.97375,1.75,130.25,1998.5,594332,137069,26609,758010,0
3007,30.61932203,5.966101695,94.03389831,1497.169492,443988,226668,26904,697560,0
3008,31.24215385,6.164835165,89.46153846,1537.406593,394540,252197,40848,687585,0
3009,22.1,5.615384615,75.57692308,1219.653846,266957,382213,30690,679860,0
3010,16.20874359,4.461538462,63.56410256,1650.205128,437946,199121,26080,663147,0
3011,20.3776087,4.869565217,67.95652174,1279.695652,196565,326061,30430,553056,0
3012,47.84837037,6.444444444,126.1111111,1995.777778,364900,127354,27418,519672,0
3013,20.03375,4.833333333,71.33333333,1631.5,181333,307566,24182,513081,0
3014,18.1925,5.074074074,60.96296296,1408.055556,186102,266876,30205,483183,0
3015,26.4498867,5.408866995,87.31034483,1623.793103,266914,190165,23486,480565,0
3016,15.46,5.0,60.8,1196.0,95303,260483,17942,373728,0
3017,29.942625,4.5,106.225,1480.575,221092,130915,20608,372615,0
3018,17.182,5.0,74.0,1994.0,214515,123743,15639,353897,0
3019,18.64264,4.84,67.0,1698.64,205295,124092,16104,345491,0
3020,12.35588235,4.647058824,53.88235294,1366.294118,121971,165216,13928,301115,0
3021,22.36209302,4.88372093,72.58139535,1743.44186,150576,78185,8743,237504,0
3022,27.23911864,3.033898305,91.61016949,1677.949153,136760,85032,14424,236216,0
3023,34.02059211,5.552631579,99.0,1920.026316,176616,48225,9910,234751,1
3024,46.06451282,6.487179487,125.4358974,1835.846154,165503,38584,11793,215880,0
3025,12.32981818,4.818181818,53.81818182,1367.272727,92260,113944,8546,214750,0
3026,28.60820513,4.756410256,92.82051282,2043.820513,165597,35097,9474,210168,0
3027,46.5274,7.04,131.6,1596.92,144603,45450,13601,203654,0
3028,20.7206,3.52,74.4,1397.8,67240,113341,15482,196063,0
3029,22.78208333,4.916666667,81.66666667,1847.666667,115766,64484,9307,189557,0
3030,26.51269565,4.02173913,93.58695652,1933.021739,135634,36561,9517,181712,0
3031,57.92693548,6.161290323,149.7096774,2283.112903,134273,36467,9327,180067,0
3032,27.46483636,4.872727273,86.45454545,1723.0,97719,69969,6980,174668,0
3033,93.71425,8.0,225.0,2979.0,134862,21275,8107,164244,0
3034,107.4521429,8.0,182.5714286,2425.428571,122403,32777,6460,161640,1
3035,39.39984314,5.784313725,117.7058824,2151.647059,107929,24303,8350,140582,0
3036,43.86363077,5.292307692,105.1692308,2083.523077,83796,48126,6447,138369,1
3037,37.31523077,4.323076923,103.6769231,1873.261538,97803,23215,7297,128315,0
3038,78.07322727,7.672727273,192.4,2598.818182,92854,16405,7504,116763,0
3039,13.11525,4.75,50.875,1430.75,54769,40967,4918,100654,0
3040,31.38814286,6.714285714,111.0,1711.571429,40285,53303,6079,99667,0
3041,19.00794118,5.205882353,66.97058824,1292.352941,54550,39820,4774,99144,0
3042,17.44569231,4.692307692,68.26923077,1791.230769,72645,20068,5871,98584,0
3043,43.54851613,1.35483871,137.7741935,2261.193548,42529,45622,6820,94971,0
3044,19.93814035,5.649122807,76.31578947,1205.192982,45482,43722,4390,93594,0
3045,17.34364706,4.745098039,70.92156863,1683.607843,52579,34333,4757,91669,0
3046,53.78571429,6.0,124.8571429,1855.0,59781,24920,4231,88932,1
3047,20.43008333,4.791666667,69.875,1773.0,66461,16617,3360,86438,0
3048,24.84390244,4.756097561,84.92682927,1982.756098,66320,15760,3734,85814,0
3049,39.35238095,5.0,98.04761905,1928.714286,69739,11216,2910,83865,0
3050,36.21929825,6.473684211,94.33333333,1424.666667,48888,29644,5330,83862,0
3051,16.05676923,4.923076923,67.0,1703.153846,52128,27183,4325,83636,0
3052,31.1045119,4.547619048,93.01190476,1699.119048,33831,41968,6273,82072,0
3053,26.803,5.428571429,85.71428571,1310.0,43253,32600,5199,81052,0
3054,22.90364865,5.405405405,75.64864865,1364.0,32594,40948,2920,76462,0
3055,14.293,4.6,75.4,1479.0,41871,30734,3648,76253,0
3056,26.3525,0.0,80.0,1498.0,33424,38864,3419,75707,0
3057,10.83275,5.0,45.0,1242.0,33183,35584,3650,72417,0
3058,37.46857143,5.857142857,103.4285714,1718.571429,31727,34974,4775,71476,0
3059,30.65053846,6.346153846,95.0,1136.692308,51686,11777,2957,66420,0
3060,23.322,3.75,84.2,1853.9,49638,14570,2194,66402,0
3061,50.96109091,6.181818182,135.2909091,1971.163636,49871,11942,4292,66105,1
3062,18.2955625,4.875,70.25,1836.5,53944,10297,1777,66018,0
3063,11.370625,5.0,48.0,1518.0,38028,23579,3139,64746,0
3064,35.28132353,5.176470588,113.3529412,2106.5,46218,14569,3649,64436,0
3065,17.22277778,4.888888889,70.0,1615.333333,36030,24008,3483,63521,0
3066,49.28583333,6.0,145.0,1963.666667,43526,15563,4046,63135,0
3067,107.6705126,8.277310924,196.3361345,2521.092437,50463,9936,2281,62680,1
3068,82.06090909,7.727272727,199.7272727,2790.454545,48642,8963,3334,60939,1
3069,35.81481651,6.293577982,117.4311927,1921.46789,39753,16488,3651,59892,0
3070,31.5255,5.166666667,109.6666667,1861.833333,36819,15104,2863,54786,0
3071,33.25025,6.166666667,112.75,1475.0,17481,33288,3564,54333,0
3072,65.56875,8.0,167.25,1998.0,43499,8541,2123,54163,0
3073,137.5695455,8.0,223.5454545,2813.0,46525,4686,2164,53375,0
3074,30.3775,6.3125,94.0625,935.625,17915,29639,2914,50468,0
3075,20.27896296,4.111111111,72.85185185,1832.888889,33183,13769,2551,49503,0
3076,24.09525,6.25,68.75,1498.25,14674,30585,2877,48136,0
3077,21.02333333,5.0,92.33333333,1729.333333,28360,18165,1540,48065,0
3078,59.0,7.0,166.0,1798.0,32899,12105,2529,47533,0
3079,72.79589474,6.210526316,166.3157895,3041.0,30584,12613,2752,45949,0
3080,30.5976,1.8,97.6,1757.6,35531,8267,1868,45666,0
3081,20.7195,4.71875,81.375,1950.90625,33088,9087,2129,44304,0
3082,25.39952941,4.647058824,78.85294118,1891.588235,31510,9786,1982,43278,0
3083,32.93965169,6.348314607,114.8202247,1615.370787,29664,11286,2029,42979,0
3084,37.00904545,4.590909091,114.6818182,2208.090909,29883,10254,2740,42877,0
3085,66.58842105,5.736842105,172.3157895,2934.631579,35536,5006,1773,42315,0
3086,64.59222222,6.777777778,178.5555556,2011.555556,25065,14213,2821,42099,0
3087,8.17,5.0,40.0,1108.0,12991,26817,2092,41900,0
3088,19.08518182,3.727272727,68.90909091,1180.545455,17927,19182,2858,39967,0
3089,13.24516667,4.833333333,66.66666667,1506.5,19953,17412,2254,39619,0
3090,27.09825,4.666666667,91.75,2247.333333,30247,7315,1675,39237,0
3091,16.29053333,4.8,57.86666667,1645.133333,25091,11103,1761,37955,0
3092,34.19,6.0,103.0,1794.0,24161,11459,1825,37445,0
3093,22.69,4.8,82.2,1773.7,26844,8769,1803,37416,0
3094,32.898125,5.333333333,116.2916667,2081.375,28591,6997,1723,37311,0
3095,36.38445588,4.5,125.7058824,2294.764706,28562,6622,1897,37081,0
3096,34.9090566,5.603773585,104.2264151,1805.924528,30090,5406,1251,36747,1
3097,30.236875,4.5,110.0,2316.0,27674,6926,1836,36436,0
3098,52.95719388,5.653061224,146.122449,2031.469388,28630,5239,2073,35942,0
3099,36.64326667,4.466666667,88.73333333,2284.133333,27384,6621,1869,35874,0
3100,32.06304348,5.956521739,89.34782609,1472.826087,22125,12365,1367,35857,1
3101,13.63642857,4.714285714,69.0,1424.857143,16759,16942,1022,34723,0
3102,7.712,5.0,29.0,899.0,12949,19586,1882,34417,0
3103,22.455,6.0,92.30769231,1466.307692,18719,13726,1747,34192,0
3104,19.37890909,4.863636364,61.27272727,1470.909091,19383,13642,909,33934,0
3105,27.4386,6.34,85.28,1452.0,22453,9676,1204,33333,1
3106,22.77681818,5.272727273,92.36363636,1837.363636,21060,10893,1111,33064,0
3107,9.8628,5.0,50.0,1090.4,16287,13631,2481,32399,0
3108,45.6995,6.0,114.0,1854.2,21454,8676,2122,32252,1
3109,77.41666667,7.0,188.3333333,2876.0,21077,8874,1752,31703,1
3110,61.86283333,6.833333333,184.1666667,2748.333333,14181,14731,2437,31349,0
3111,113.2693333,8.0,246.3333333,2994.666667,23115,6850,1313,31278,1
3112,42.66935185,5.907407407,118.1851852,2095.185185,23772,5524,1071,30367,0
3113,47.361875,3.75,113.375,1774.8125,20968,6909,1476,29353,1
3114,15.14,5.0,64.0,1382.75,13128,15285,838,29251,0
3115,7.92,4.0,33.33333333,868.3333333,13474,14339,1327,29140,0
3116,11.389,4.142857143,53.0,1308.285714,10392,16682,1599,28673,0
3117,9.5628,4.6,50.0,996.0,11475,13920,2853,28248,0
3118,15.40377778,5.0,60.11111111,1593.111111,20538,6548,943,28029,0
3119,43.08,4.666666667,105.0,2239.666667,18342,7595,1985,27922,0
3120,18.84548718,4.076923077,87.07692308,2326.358974,23365,3566,751,27682,0
3121,13.88308333,4.75,47.75,1373.75,8087,17473,1620,27180,0
3122,41.616,4.6,125.36,2336.52,21126,4433,1454,27013,0
3123,17.03876744,5.302325581,73.48837209,1374.046512,12702,12857,1391,26950,0
3124,115.533,8.0,250.0,2998.0,22616,2464,1285,26365,0
3125,39.70773684,4.842105263,117.5789474,2719.842105,16712,7766,1213,25691,1
3126,158.7922667,7.466666667,293.5333333,3005.4,21932,2273,1126,25331,0
3127,14.350125,4.875,59.5,1642.875,17022,7058,1002,25082,0
3128,37.01736842,4.736842105,97.57894737,2697.368421,17099,6332,979,24410,1
3129,25.94322222,4.777777778,67.0,1372.666667,9454,11984,2073,23511,0
3130,20.1241875,4.875,79.875,1836.875,16277,5655,1042,22974,0
3131,32.09,4.0,98.2,1754.4,10159,11532,1239,22930,0
3132,62.39565385,4.384615385,135.5,2972.307692,17835,3829,1194,22858,0
3133,52.085,8.0,223.8333333,1969.0,18271,3064,1213,22548,0
3134,10.42388889,5.0,52.44444444,1095.777778,10116,11397,935,22448,0
3135,16.4455,4.666666667,78.0,1741.0,14738,6636,1036,22410,0
3136,22.95871429,6.285714286,80.0,998.0,13677,7773,716,22166,0
3137,83.50125,6.5,213.5,3071.0,16330,4345,1358,22033,0
3138,37.52210345,3.896551724,107.3793103,2084.37931,15352,4950,1387,21689,0
3139,25.3433871,5.193548387,95.09677419,1802.774194,12401,7242,1069,20712,0
3140,39.7374,4.6,115.0,2234.4,10687,8175,1314,20176,0
3141,11.28285714,4.285714286,49.28571429,1337.714286,10542,8342,987,19871,0
3142,49.82277778,6.0,115.8333333,1746.944444,13033,5330,1335,19698,0
3143,12.47666667,4.666666667,58.66666667,1498.0,11334,7177,1079,19590,0
3144,19.45142857,3.571428571,61.0,1197.0,9274,8493,1699,19466,0
3145,30.86290909,4.454545455,105.5454545,2458.909091,16143,2592,702,19437,0
3146,43.06842105,6.254385965,104.2017544,2222.710526,15856,1760,1305,18921,1
3147,30.99,0.0,105.0,335.0,14275,3791,447,18513,0
3148,14.4382,4.9,64.2,1891.7,13924,3910,598,18432,0
3149,30.99513158,5.789473684,101.8947368,1905.631579,10954,6528,593,18075,0
3150,13.70454545,4.818181818,47.45454545,1384.0,5986,10381,807,17174,0
3151,20.37,5.642857143,74.21428571,1324.357143,12935,3431,678,17044,0
3152,50.94,6.266666667,138.2833333,1986.766667,14203,1864,922,16989,1
3153,27.78966667,4.666666667,110.6666667,2050.333333,11731,3964,824,16519,0
3154,135.1055,6.5,309.0,3999.0,14267,1594,609,16470,0
3155,37.4265,6.2,104.2,1796.6,8817,6734,910,16461,0
3156,23.0525,5.0,55.0,1406.0,7463,7905,1063,16431,0
3157,29.88478947,4.736842105,109.1052632,2238.631579,9785,5820,766,16371,0
3158,16.59192308,5.0,52.84615385,998.0,5983,9724,551,16258,0
3159,29.151,5.0,89.0,2526.5,11431,4145,633,16209,0
3160,145.6466667,6.0,283.0,5000.0,13095,2165,761,16021,0
3161,19.71783333,4.0,98.0,1995.0,10242,4865,793,15900,0
3162,23.16515789,3.947368421,82.15789474,1817.315789,9922,5166,602,15690,0
3163,42.74666667,5.0,128.5,2548.833333,13085,1945,449,15479,0
3164,51.646,0.0,110.0,1995.0,10293,4079,1092,15464,0
3165,32.723,3.6,96.0,1498.0,8100,6514,819,15433,0
3166,23.16515789,3.947368421,82.15789474,1817.315789,9649,4584,953,15186,0
3167,32.98557692,6.230769231,94.03846154,1528.807692,8831,5124,918,14873,1
3168,25.08266667,4.533333333,93.6,2127.333333,11665,2475,592,14732,0
3169,44.14181818,6.545454545,144.6363636,2242.636364,9948,4079,418,14445,1
3170,22.95383333,5.0,67.33333333,1908.166667,9290,3777,774,13841,0
3171,25.2075,5.0,80.5,1753.0,8096,4873,788,13757,0
3172,43.97,6.6,115.3,1634.2,8385,4867,499,13751,1
3173,7.863333333,5.0,44.0,1289.0,8874,4103,542,13519,0
3174,264.675,7.0,420.0,6208.0,10040,2716,714,13470,0
3175,26.0,5.0,70.0,1597.0,2338,10611,492,13441,0
3176,18.76848837,4.860465116,67.02325581,1391.023256,7873,4690,706,13269,1
3177,9.358333333,4.333333333,47.0,1324.0,6099,6454,653,13206,0
3178,23.585,5.8125,80.8125,1446.125,7765,4543,641,12949,1
3179,85.82946154,8.0,213.1538462,1969.0,8412,3636,877,12925,0
3180,20.49710714,4.142857143,72.42857143,1824.428571,8964,3189,577,12730,0
3181,16.67175,4.5,74.0,1541.5,7875,4105,738,12718,0
3182,17.587,4.083333333,73.08333333,1363.5,7471,4305,650,12426,0
3183,32.11766667,4.666666667,115.3333333,2362.0,9084,2736,474,12294,0
3184,17.31241935,4.967741935,66.35483871,1655.741935,7555,3629,553,11737,0
3185,18.513,4.6,76.0,1599.0,7215,3853,267,11335,0
3186,29.26025,5.95,90.625,1462.3625,7713,3098,280,11091,0
3187,24.84,5.0,102.0,2244.0,8082,2180,456,10718,0
3188,38.72769231,5.538461538,114.6538462,2178.192308,8649,1690,375,10714,1
3189,107.6705126,8.277310924,196.3361345,2521.092437,9373,1022,298,10693,1
3190,30.0062,3.2,115.4666667,2245.6,8417,1718,551,10686,0
3191,37.32636,4.76,101.12,2349.08,8457,1658,476,10591,0
3192,52.19640625,5.3125,126.5,2323.9375,7055,2843,561,10459,0
3193,31.195,6.0,105.875,1755.75,7250,2827,252,10329,0
3194,36.01325,6.0,151.6666667,2048.666667,7589,2340,242,10171,0
3195,20.36464286,5.857142857,82.25,1534.392857,6678,2989,372,10039,1
3196,23.245,4.5,98.0,1998.0,7369,1941,452,9762,0
3197,14.7754,4.8,51.4,1428.4,4309,4641,482,9432,0
3198,64.109625,6.75,202.125,2778.0,5878,2863,667,9408,0
3199,23.01661538,4.730769231,90.88461538,1709.538462,6778,2241,348,9367,0
3200,18.88233333,4.666666667,74.0,1523.333333,5927,2742,526,9195,0
3201,36.70125,4.875,91.75,2019.75,6292,2417,437,9146,0
3202,26.19775,4.625,77.0,1495.0,4340,4383,419,9142,0
3203,16.80266667,4.5,71.0,1764.0,6718,2013,404,9135,0
3204,20.35378947,4.789473684,67.68421053,1996.684211,6647,1805,405,8857,0
3205,23.22409091,4.909090909,82.0,1938.0,5635,2808,380,8823,0
3206,13.2053,6.0,35.8,679.0,4003,4204,515,8722,0
3207,22.127,5.0,83.0,1721.5,4525,3517,495,8537,0
3208,21.6,6.0,64.625,1496.0,4171,3972,320,8463,0
3209,53.792,6.0,134.3333333,1730.0,7220,836,340,8396,0
3210,29.57028571,5.0,84.0,1997.142857,5737,2179,459,8375,1
3211,25.29875,4.5,94.0,1998.0,5256,2474,598,8328,0
3212,17.82333333,4.666666667,70.33333333,1298.666667,4154,3750,352,8256,0
3213,15.16166667,4.666666667,75.0,1594.0,5566,2291,332,8189,0
3214,76.5922,8.0,184.0,2396.4,4726,2847,439,8012,0
3215,30.352,4.4,99.0,2117.6,5225,2423,257,7905,0
3216,25.17006452,5.516129032,79.30645161,1523.741935,5617,1975,232,7824,1
3217,18.16715385,4.692307692,70.30769231,1932.153846,5577,1883,357,7817,0
3218,14.333375,4.5625,59.875,1183.25,3184,4126,364,7674,0
3219,40.7645,4.333333333,133.3333333,2634.222222,5440,1076,375,6891,0
3220,11.74,5.0,63.0,1405.0,3106,3393,303,6802,0
3221,31.7425,4.833333333,119.6666667,2116.0,5043,1222,272,6537,0
3222,36.90769355,4.5,126.1451613,2344.0,5342,854,320,6516,0
3223,28.9602,4.4,100.8,1936.6,4947,1185,375,6507,0
3224,13.191,5.0,51.33333333,1431.333333,2557,3550,327,6434,0
3225,35.86943902,5.585365854,117.0243902,1980.634146,5271,861,236,6368,0
3226,20.74,5.0,75.0,1695.0,3322,2802,242,6366,0
3227,108.7471951,7.853658537,207.6097561,2304.97561,4863,1004,340,6207,1
3228,59.4905,5.0,137.5,2734.5,5227,737,236,6200,0
3229,81.295,8.0,250.0,2998.0,5306,652,198,6156,0
3230,35.34,5.0,118.0,1781.0,5050,728,237,6015,0
3231,11.7129,4.0,69.0,1864.8,5006,774,124,5904,0
3232,55.25,6.0,177.0,1997.0,4287,1277,336,5900,0
3233,14.76166667,4.666666667,75.0,1594.0,3663,1941,260,5864,0
3234,116.545,8.0,230.0,2981.0,5138,391,266,5795,0
3235,36.52419118,5.176470588,113.3529412,2106.5,3855,1342,353,5550,0
3236,11.745,5.0,51.0,998.0,2484,2594,426,5504,0
3237,76.71,0.0,336.0,0.0,4201,1068,200,5469,0
3238,158.976,8.0,326.0,3295.0,4082,1129,236,5447,0
3239,31.30566667,6.259259259,96.92592593,1587.222222,3909,1270,232,5411,0
3240,43.9745,4.5,98.0,2309.0,3314,1723,301,5338,0
3241,38.48247059,4.882352941,90.94117647,2953.588235,4271,883,181,5335,1
3242,114.8758333,8.0,235.0,2979.0,4443,634,212,5289,0
3243,45.59125,5.25,104.1666667,2027.833333,3446,1620,222,5288,0
3244,18.19842857,5.0,87.71428571,1696.428571,3703,1289,290,5282,0
3245,46.5274,7.04,131.6,1596.92,4519,514,194,5227,0
3246,31.79107143,4.571428571,104.1428571,2211.071429,4032,795,252,5079,0
3247,45.76307692,5.307692308,109.0769231,2053.0,3275,1496,271,5042,1
3248,33.70615385,6.153846154,120.1538462,1750.615385,3833,984,213,5030,0
3249,19.055,4.6,89.2,1827.8,3739,1079,147,4965,0
3250,39.725,6.8,110.0,1592.0,4177,520,238,4935,0
3251,24.35,6.0,60.0,698.0,2841,1705,248,4794,0
3252,94.098125,8.0,190.0,2967.0,3449,1128,201,4778,1
3253,41.59161538,6.461538462,111.3076923,1624.769231,3144,1432,96,4672,0
3254,33.798,0.0,96.0,1797.4,3010,1004,491,4505,0
3255,36.35965,4.55,110.5,2345.1,3791,516,191,4498,0
3256,55.2,6.0,163.5,2696.5,2961,1237,260,4458,0
3257,17.91985714,4.19047619,64.47619048,1759.190476,3204,962,190,4356,0
3258,48.09553571,5.107142857,117.7857143,2315.0,3587,487,166,4240,0
3259,60.87,6.75,228.0,1984.0,3380,673,182,4235,0
3260,34.10357143,4.571428571,121.8571429,2555.285714,3454,565,212,4231,0
3261,21.407,4.5,72.0,1974.0,2817,1036,217,4070,0
3262,30.081,4.0,110.0,2254.0,2643,1059,289,3991,0
3263,55.4225,6.0,221.0,3498.0,3265,485,161,3911,0
3264,24.674,0.0,60.0,160.0,1813,1803,218,3834,0
3265,27.935,5.0,103.5,1833.0,2338,1230,264,3832,0
3266,46.60136364,6.0,110.0,2393.0,3030,596,146,3772,1
3267,17.42714286,5.0,87.71428571,1696.428571,2477,958,188,3623,0
3268,57.22905851,5.234042553,120.4255319,2309.340426,2545,792,222,3559,1
3269,30.92666667,4.666666667,110.3333333,2328.333333,2482,795,168,3445,0
3270,69.397,5.0,173.0,3358.666667,2813,416,188,3417,0
3271,27.13,5.768421053,96.05263158,1774.778947,2009,898,479,3386,1
3272,58.46907407,6.444444444,148.5185185,2174.037037,2484,634,249,3367,1
3273,11.14333333,5.0,50.0,998.0,1035,2037,107,3179,0
3274,33.12857143,5.285714286,103.0,1914.714286,1873,1078,147,3098,0
3275,9.492272727,4.909090909,40.81818182,850.2727273,1250,1660,173,3083,0
3276,95.29916667,6.333333333,253.6666667,3764.333333,2551,377,123,3051,0
3277,285.247,7.2,428.2,5577.8,2710,202,101,3013,0
3278,8.4656,4.6,41.4,1182.4,2275,594,104,2973,0
3279,134.789,8.0,390.0,4395.0,2566,144,106,2816,0
3280,38.79428571,4.428571429,98.57142857,2755.571429,2132,503,106,2741,1
3281,44.62833333,4.333333333,127.6666667,3100.333333,2070,494,53,2617,1
3282,14.22409091,4.727272727,64.45454545,1353.363636,1364,1053,148,2565,0
3283,17.5296,4.6,78.4,1549.8,1946,512,89,2547,0
3284,28.379,4.6,91.6,2181.2,2025,409,91,2525,0
3285,158.823,4.5,250.0,3228.0,2138,186,99,2423,0
3286,43.89111111,5.666666667,130.5555556,2457.555556,2013,269,125,2407,0
3287,28.803,4.8,111.2,2126.8,1949,341,60,2350,0
3288,20.31264706,5.352941176,63.29411765,1344.823529,1304,966,69,2339,1
3289,19.9680625,2.8125,55.375,592.5625,1138,1061,125,2324,0
3290,38.025,4.5,129.5,2614.0,1501,714,93,2308,0
3291,23.90933333,5.0,100.6666667,2016.777778,1876,307,96,2279,0
3292,13.382,2.5,48.0,1343.0,720,1377,120,2217,0
3293,56.15916667,5.5,174.3333333,3199.0,1542,569,103,2214,0
3294,15.764,5.0,66.0,1497.0,1035,995,123,2153,0
3295,23.16515789,3.947368421,82.15789474,1817.315789,1285,671,106,2062,0
3296,22.35277778,4.222222222,80.92592593,1977.259259,1662,311,80,2053,0
3297,10.32442857,4.142857143,54.35714286,1463.857143,1171,754,79,2004,0
3298,12.25,5.0,43.0,1325.0,1359,557,76,1992,0
3299,19.895,4.8,94.0,1742.6,1390,483,31,1904,0
3300,37.44666667,2.611111111,120.3333333,2085.055556,1302,529,73,1904,0
3301,28.96891667,5.0,72.625,1707.125,1139,616,113,1868,0
3302,15.20916667,5.0,53.0,998.0,640,1041,143,1824,0
3303,45.78386047,4.813953488,106.3023256,2768.511628,1414,314,82,1810,1
3304,37.350625,5.375,121.0625,1972.8125,1393,336,74,1803,0
3305,35.25972727,4.727272727,104.6363636,2367.181818,1429,264,74,1767,0
3306,12.924,4.0,43.0,989.0,724,893,107,1724,0
3307,111.993,5.0,220.0,4988.0,1464,152,65,1681,0
3308,28.735,4.666666667,100.6666667,1590.0,1040,543,82,1665,0
3309,18.76285714,4.714285714,80.42857143,1612.928571,1133,416,109,1658,0
3310,110.0985,5.0,235.0,4957.0,1462,111,78,1651,0
3311,38.39725,4.75,131.0,2652.375,1386,164,76,1626,0
3312,646.605,6.0,450.0,5733.0,1428,136,60,1624,0
3313,54.2675,5.666666667,114.0,1998.0,1144,343,47,1534,1
3314,11.63114286,4.428571429,47.14285714,1477.0,1031,453,48,1532,0
3315,20.65665217,4.956521739,67.0,2234.26087,1081,294,92,1467,0
3316,28.295,5.0,96.0,1747.0,963,377,90,1430,0
3317,53.62733333,0.0,122.6666667,2331.333333,998,269,101,1368,0
3318,273.755,6.0,381.0,5935.0,1245,80,33,1358,0
3319,35.29583333,5.0,102.0,2129.0,841,433,63,1337,0
3320,6.494,5.0,30.0,903.0,646,625,59,1330,0
3321,93.42433333,5.0,233.0,2995.0,1243,40,38,1321,0
3322,13.137,5.0,93.5,1998.0,1064,143,53,1260,0
3323,13.48615385,5.0,52.38461538,1028.923077,483,724,34,1241,0
3324,35.27,6.0,112.0714286,1574.428571,757,372,109,1238,0
3325,6.050333333,4.333333333,52.0,1335.0,810,383,35,1228,0
3326,200.19825,6.0,294.0,3586.0,1071,55,43,1169,0
3327,107.7,5.0,274.0,3800.5,1043,81,31,1155,0
3328,61.235,5.0,147.0,2144.0,1002,98,42,1142,0
3329,60.9552,5.5,146.0,2588.6,778,233,127,1138,1
3330,22.12540909,5.5,75.09090909,1622.681818,652,396,37,1085,0
3331,51.6415625,5.375,126.5,2376.75,872,153,49,1074,0
3332,41.38957143,7.285714286,105.7142857,1545.428571,601,382,52,1035,1
3333,16.641,4.5,71.0,1590.0,322,630,54,1006,0
3334,10.9158,5.0,49.8,1372.4,773,212,19,1004,0
3335,18.53214286,5.714285714,68.57142857,1166.142857,568761,625691,51273,1245725,0
3336,16.20874359,4.461538462,63.56410256,1650.205128,524392,241476,31295,797163,0
3337,39.97375,1.75,130.25,1998.5,594469,138468,26372,759309,0
3338,31.24215385,6.164835165,89.46153846,1537.406593,379260,241938,38948,660146,0
3339,22.1,5.615384615,75.57692308,1219.653846,256964,367492,29155,653611,0
3340,30.61932203,5.966101695,94.03389831,1497.169492,373008,189997,21230,584235,0
3341,20.3776087,4.869565217,67.95652174,1279.695652,201479,328691,29555,559725,0
3342,47.84837037,6.444444444,126.1111111,1995.777778,348430,123339,25689,497458,0
3343,18.1925,5.074074074,60.96296296,1408.055556,185258,259214,28941,473413,0
3344,26.4498867,5.408866995,87.31034483,1623.793103,251947,175070,20606,447623,0
3345,20.03375,4.833333333,71.33333333,1631.5,160059,266016,19704,445779,0
3346,17.182,5.0,74.0,1994.0,256804,141474,18092,416370,0
3347,18.64264,4.84,67.0,1698.64,213123,128903,16562,358588,0
3348,29.942625,4.5,106.225,1480.575,210403,127017,19278,356698,0
3349,15.46,5.0,60.8,1196.0,88606,234542,15869,339017,0
3350,12.35588235,4.647058824,53.88235294,1366.294118,123975,177930,14762,316667,0
3351,34.02059211,5.552631579,99.0,1920.026316,175187,48026,9436,232649,1
3352,27.23911864,3.033898305,91.61016949,1677.949153,131586,81030,13551,226167,0
3353,12.32981818,4.818181818,53.81818182,1367.272727,93107,116897,8385,218389,0
3354,22.36209302,4.88372093,72.58139535,1743.44186,133618,68073,7120,208811,0
3355,28.60820513,4.756410256,92.82051282,2043.820513,164675,34492,9109,208276,0
3356,46.06451282,6.487179487,125.4358974,1835.846154,149432,34861,10423,194716,0
3357,26.51269565,4.02173913,93.58695652,1933.021739,142077,38129,9196,189402,0
3358,46.5274,7.04,131.6,1596.92,131397,39741,11166,182304,0
3359,22.78208333,4.916666667,81.66666667,1847.666667,106564,59896,7634,174094,0
3360,20.7206,3.52,74.4,1397.8,57983,92786,12984,163753,0
3361,93.71425,8.0,225.0,2979.0,132210,21236,7797,161243,0
3362,57.92693548,6.161290323,149.7096774,2283.112903,115546,30467,7796,153809,0
3363,107.4521429,8.0,182.5714286,2425.428571,115975,31547,6169,153691,1
3364,39.39984314,5.784313725,117.7058824,2151.647059,108082,24654,8171,140907,0
3365,27.46483636,4.872727273,86.45454545,1723.0,78234,53325,4961,136520,0
3366,13.11525,4.75,50.875,1430.75,70621,54720,6595,131936,0
3367,43.86363077,5.292307692,105.1692308,2083.523077,73527,42062,5721,121310,1
3368,20.43008333,4.791666667,69.875,1773.0,87195,21662,4501,113358,0
3369,17.44569231,4.692307692,68.26923077,1791.230769,83460,22992,6650,113102,0
3370,37.31523077,4.323076923,103.6769231,1873.261538,85695,20393,6152,112240,0
3371,78.07322727,7.672727273,192.4,2598.818182,87523,15459,6806,109788,0
3372,18.2955625,4.875,70.25,1836.5,85782,17224,2972,105978,0
3373,17.34364706,4.745098039,70.92156863,1683.607843,57583,37884,5129,100596,0
3374,24.84390244,4.756097561,84.92682927,1982.756098,76796,18445,4154,99395,0
3375,16.05676923,4.923076923,67.0,1703.153846,61050,32504,5027,98581,0
3376,10.83275,5.0,45.0,1242.0,40714,45830,4659,91203,0
3377,19.93814035,5.649122807,76.31578947,1205.192982,42227,39817,4106,86150,0
3378,19.00794118,5.205882353,66.97058824,1292.352941,45819,32791,3996,82606,0
3379,43.54851613,1.35483871,137.7741935,2261.193548,37297,39266,5889,82452,0
3380,53.78571429,6.0,124.8571429,1855.0,54754,22596,3843,81193,1
3381,26.803,5.428571429,85.71428571,1310.0,40697,31226,5021,76944,0
3382,14.293,4.6,75.4,1479.0,42174,30951,3484,76609,0
3383,31.38814286,6.714285714,111.0,1711.571429,32281,37551,4482,74314,0
3384,31.1045119,4.547619048,93.01190476,1699.119048,30478,36674,4866,72018,0
3385,39.35238095,5.0,98.04761905,1928.714286,58756,9263,2427,70446,0
3386,17.22277778,4.888888889,70.0,1615.333333,38828,25298,3520,67646,0
3387,11.370625,5.0,48.0,1518.0,39836,24625,3124,67585,0
3388,37.46857143,5.857142857,103.4285714,1718.571429,30033,32817,4524,67374,0
3389,36.21929825,6.473684211,94.33333333,1424.666667,37962,23249,4219,65430,0
3390,20.27896296,4.111111111,72.85185185,1832.888889,41868,17437,3180,62485,0
3391,23.322,3.75,84.2,1853.9,46615,12864,1867,61346,0
3392,50.96109091,6.181818182,135.2909091,1971.163636,44580,10532,4074,59186,1
3393,35.28132353,5.176470588,113.3529412,2106.5,42251,13233,3394,58878,0
3394,22.90364865,5.405405405,75.64864865,1364.0,26082,30698,1936,58716,0
3395,35.81481651,6.293577982,117.4311927,1921.46789,38047,15738,3532,57317,0
3396,107.6705126,8.277310924,196.3361345,2521.092437,44779,8608,2190,55577,1
3397,137.5695455,8.0,223.5454545,2813.0,48200,4904,2169,55273,0
3398,30.65053846,6.346153846,95.0,1136.692308,42546,9536,2311,54393,0
3399,16.29053333,4.8,57.86666667,1645.133333,35626,15973,2543,54142,0
3400,82.06090909,7.727272727,199.7272727,2790.454545,42182,7788,2932,52902,1
3401,31.5255,5.166666667,109.6666667,1861.833333,35478,14318,2802,52598,0
3402,49.28583333,6.0,145.0,1963.666667,35734,12994,3383,52111,0
3403,20.7195,4.71875,81.375,1950.90625,38330,10318,2341,50989,0
3404,30.3775,6.3125,94.0625,935.625,18340,28877,2842,50059,0
3405,26.3525,0.0,80.0,1498.0,22542,25482,1978,50002,0
3406,15.40377778,5.0,60.11111111,1593.111111,35460,11563,1726,48749,0
3407,33.25025,6.166666667,112.75,1475.0,17217,27691,3106,48014,0
3408,27.09825,4.666666667,91.75,2247.333333,36464,8946,2057,47467,0
3409,37.00904545,4.590909091,114.6818182,2208.090909,32739,11170,3045,46954,0
3410,59.0,7.0,166.0,1798.0,32490,11930,2475,46895,0
3411,8.17,5.0,40.0,1108.0,13178,26854,2015,42047,0
3412,30.5976,1.8,97.6,1757.6,32554,7664,1786,42004,0
3413,65.56875,8.0,167.25,1998.0,33436,6778,1569,41783,0
3414,18.84548718,4.076923077,87.07692308,2326.358974,34938,5334,1185,41457,0
3415,36.64326667,4.466666667,88.73333333,2284.133333,31374,7768,2198,41340,0
3416,13.24516667,4.833333333,66.66666667,1506.5,20532,17572,2183,40287,0
3417,21.02333333,5.0,92.33333333,1729.333333,23985,14494,1234,39713,0
3418,30.236875,4.5,110.0,2316.0,29896,7476,2017,39389,0
3419,72.79589474,6.210526316,166.3157895,3041.0,26502,10393,2210,39105,0
3420,7.712,5.0,29.0,899.0,14078,22416,2186,38680,0
3421,36.38445588,4.5,125.7058824,2294.764706,29670,6866,2010,38546,0
3422,14.350125,4.875,59.5,1642.875,25621,11105,1617,38343,0
3423,34.19,6.0,103.0,1794.0,25017,11317,1863,38197,0
3424,19.08518182,3.727272727,68.90909091,1180.545455,16993,18368,2586,37947,0
3425,22.69,4.8,82.2,1773.7,27233,8806,1693,37732,0
3426,66.58842105,5.736842105,172.3157895,2934.631579,30966,4322,1519,36807,0
3427,25.39952941,4.647058824,78.85294118,1891.588235,26489,8146,1663,36298,0
3428,64.59222222,6.777777778,178.5555556,2011.555556,22571,11305,2387,36263,0
3429,22.455,6.0,92.30769231,1466.307692,19896,14452,1767,36115,0
3430,32.93965169,6.348314607,114.8202247,1615.370787,23699,8952,1793,34444,0
3431,24.09525,6.25,68.75,1498.25,11038,21092,2100,34230,0
3432,32.898125,5.333333333,116.2916667,2081.375,26254,6260,1480,33994,0
3433,41.616,4.6,125.36,2336.52,25643,5348,1708,32699,0
3434,7.92,4.0,33.33333333,868.3333333,14595,15975,1479,32049,0
3435,52.95719388,5.653061224,146.122449,2031.469388,24992,4365,1852,31209,0
3436,11.28285714,4.285714286,49.28571429,1337.714286,16146,13413,1574,31133,0
3437,34.9090566,5.603773585,104.2264151,1805.924528,24943,4234,947,30124,1
3438,11.389,4.142857143,53.0,1308.285714,10547,17463,1584,29594,0
3439,9.8628,5.0,50.0,1090.4,14853,12042,2331,29226,0
3440,45.6995,6.0,114.0,1854.2,19468,7764,1902,29134,1
3441,27.4386,6.34,85.28,1452.0,19300,8320,940,28560,1
3442,77.41666667,7.0,188.3333333,2876.0,18957,7785,1550,28292,1
3443,22.77681818,5.272727273,92.36363636,1837.363636,18026,9063,853,27942,0
3444,115.533,8.0,250.0,2998.0,23845,2568,1283,27696,0
3445,14.4382,4.9,64.2,1891.7,20821,5839,1012,27672,0
3446,19.37890909,4.863636364,61.27272727,1470.909091,15751,11060,635,27446,0
3447,43.08,4.666666667,105.0,2239.666667,17629,7367,1838,26834,0
3448,13.88308333,4.75,47.75,1373.75,7728,16599,1509,25836,0
3449,62.39565385,4.384615385,135.5,2972.307692,19683,4287,1334,25304,0
3450,16.4455,4.666666667,78.0,1741.0,16566,7477,1151,25194,0
3451,61.86283333,6.833333333,184.1666667,2748.333333,11440,11573,1928,24941,0
3452,20.1241875,4.875,79.875,1836.875,17320,5946,1064,24330,0
3453,12.47666667,4.666666667,58.66666667,1498.0,13844,8861,1225,23930,0
3454,17.03876744,5.302325581,73.48837209,1374.046512,10997,11571,1262,23830,0
3455,13.63642857,4.714285714,69.0,1424.857143,11716,11096,720,23532,0
3456,37.01736842,4.736842105,97.57894737,2697.368421,16457,5975,1025,23457,1
3457,113.2693333,8.0,246.3333333,2994.666667,16677,4854,922,22453,1
3458,158.7922667,7.466666667,293.5333333,3005.4,19448,1939,957,22344,0
3459,30.86290909,4.454545455,105.5454545,2458.909091,18439,2948,789,22176,0
3460,32.06304348,5.956521739,89.34782609,1472.826087,13598,7485,744,21827,1
3461,9.5628,4.6,50.0,996.0,8797,10732,2242,21771,0
3462,39.70773684,4.842105263,117.5789474,2719.842105,14129,6392,999,21520,1
3463,37.52210345,3.896551724,107.3793103,2084.37931,15065,5010,1407,21482,0
3464,25.94322222,4.777777778,67.0,1372.666667,8243,10379,1960,20582,0
3465,47.361875,3.75,113.375,1774.8125,14849,4841,829,20519,1
3466,39.7374,4.6,115.0,2234.4,10559,8222,1356,20137,0
3467,42.66935185,5.907407407,118.1851852,2095.185185,15734,3590,693,20017,0
3468,23.585,5.8125,80.8125,1446.125,11742,6854,1012,19608,1
3469,10.42388889,5.0,52.44444444,1095.777778,9036,9649,864,19549,0
3470,32.09,4.0,98.2,1754.4,8750,9642,1046,19438,0
3471,27.78966667,4.666666667,110.6666667,2050.333333,13209,4605,956,18770,0
3472,7.863333333,5.0,44.0,1289.0,12070,5752,730,18552,0
3473,83.50125,6.5,213.5,3071.0,13714,3400,1195,18309,0
3474,22.95871429,6.285714286,80.0,998.0,11439,6140,571,18150,0
3475,20.37,5.642857143,74.21428571,1324.357143,13361,3622,635,17618,0
3476,15.14,5.0,64.0,1382.75,8218,8912,426,17556,0
3477,43.06842105,6.254385965,104.2017544,2222.710526,14758,1594,1140,17492,1
3478,49.82277778,6.0,115.8333333,1746.944444,11602,4612,1198,17412,0
3479,25.3433871,5.193548387,95.09677419,1802.774194,10291,6029,897,17217,0
3480,13.70454545,4.818181818,47.45454545,1384.0,6040,10183,778,17001,0
3481,25.08266667,4.533333333,93.6,2127.333333,13339,2884,667,16890,0
3482,52.085,8.0,223.8333333,1969.0,13573,2175,970,16718,0
3483,23.16515789,3.947368421,82.15789474,1817.315789,10436,5030,997,16463,0
3484,19.71783333,4.0,98.0,1995.0,10661,4853,805,16319,0
3485,20.49710714,4.142857143,72.42857143,1824.428571,11437,4066,748,16251,0
3486,29.151,5.0,89.0,2526.5,11373,4239,605,16217,0
3487,9.358333333,4.333333333,47.0,1324.0,7121,7831,770,15722,0
3488,19.45142857,3.571428571,61.0,1197.0,7633,6690,1377,15700,0
3489,30.99,0.0,105.0,335.0,12063,3169,371,15603,0
3490,16.67175,4.5,74.0,1541.5,9691,4913,912,15516,0
3491,135.1055,6.5,309.0,3999.0,13331,1448,556,15335,0
3492,145.6466667,6.0,283.0,5000.0,12167,1961,689,14817,0
3493,50.94,6.266666667,138.2833333,1986.766667,12404,1546,808,14758,1
3494,32.723,3.6,96.0,1498.0,7667,6211,737,14615,0
3495,22.95383333,5.0,67.33333333,1908.166667,9644,3977,794,14415,0
3496,20.35378947,4.789473684,67.68421053,1996.684211,10635,2930,618,14183,0
3497,23.0525,5.0,55.0,1406.0,6741,6510,922,14173,0
3498,29.88478947,4.736842105,109.1052632,2238.631579,8332,4820,648,13800,0
3499,37.32636,4.76,101.12,2349.08,10774,2120,597,13491,0
3500,23.16515789,3.947368421,82.15789474,1817.315789,8689,4258,531,13478,0
3501,107.6705126,8.277310924,196.3361345,2521.092437,11707,1337,395,13439,1
3502,51.646,0.0,110.0,1995.0,8916,3477,969,13362,0
3503,17.587,4.083333333,73.08333333,1363.5,7718,4565,646,12929,0
3504,25.2075,5.0,80.5,1753.0,7430,4297,693,12420,0
3505,30.0062,3.2,115.4666667,2245.6,9726,1969,629,12324,0
3506,32.11766667,4.666666667,115.3333333,2362.0,9051,2768,458,12277,0
3507,17.31241935,4.967741935,66.35483871,1655.741935,7969,3757,546,12272,0
3508,264.675,7.0,420.0,6208.0,9054,2476,625,12155,0
3509,24.84,5.0,102.0,2244.0,9082,2526,487,12095,0
3510,42.74666667,5.0,128.5,2548.833333,10196,1505,327,12028,0
3511,18.76848837,4.860465116,67.02325581,1391.023256,6938,4260,617,11815,1
3512,44.14181818,6.545454545,144.6363636,2242.636364,8096,3201,346,11643,1
3513,16.80266667,4.5,71.0,1764.0,8513,2488,490,11491,0
3514,23.245,4.5,98.0,1998.0,7958,1983,456,10397,0
3515,43.97,6.6,115.3,1634.2,5964,3509,394,9867,1
3516,14.7754,4.8,51.4,1428.4,4389,4572,452,9413,0
3517,26.0,5.0,70.0,1597.0,1799,7222,340,9361,0
3518,22.127,5.0,83.0,1721.5,4832,3799,539,9170,0
3519,52.19640625,5.3125,126.5,2323.9375,6290,2328,540,9158,0
3520,18.16715385,4.692307692,70.30769231,1932.153846,6316,2073,390,8779,0
3521,23.22409091,4.909090909,82.0,1938.0,5460,2651,338,8449,0
3522,18.513,4.6,76.0,1599.0,5466,2769,202,8437,0
3523,36.70125,4.875,91.75,2019.75,5764,2203,385,8352,0
3524,25.29875,4.5,94.0,1998.0,5194,2481,596,8271,0
3525,15.16166667,4.666666667,75.0,1594.0,5661,2251,316,8228,0
3526,29.57028571,5.0,84.0,1997.142857,5705,2064,430,8199,1
3527,31.195,6.0,105.875,1755.75,5716,2181,192,8089,0
3528,53.792,6.0,134.3333333,1730.0,6879,841,329,8049,0
3529,85.82946154,8.0,213.1538462,1969.0,5260,2174,538,7972,0
3530,31.30566667,6.259259259,96.92592593,1587.222222,5795,1855,307,7957,0
3531,20.36464286,5.857142857,82.25,1534.392857,5121,2597,236,7954,1
3532,26.19775,4.625,77.0,1495.0,3800,3796,354,7950,0
3533,18.88233333,4.666666667,74.0,1523.333333,4826,2132,452,7410,0
3534,30.99513158,5.789473684,101.8947368,1905.631579,4699,2475,220,7394,0
3535,40.7645,4.333333333,133.3333333,2634.222222,5877,1130,378,7385,0
3536,32.98557692,6.230769231,94.03846154,1528.807692,4461,2461,462,7384,1
3537,35.86943902,5.585365854,117.0243902,1980.634146,6128,973,261,7362,0
3538,28.9602,4.4,100.8,1936.6,5532,1289,391,7212,0
3539,13.191,5.0,51.33333333,1431.333333,2798,3954,374,7126,0
3540,64.109625,6.75,202.125,2778.0,4413,1984,508,6905,0
3541,31.7425,4.833333333,119.6666667,2116.0,5328,1274,294,6896,0
3542,23.01661538,4.730769231,90.88461538,1709.538462,4752,1785,296,6833,0
3543,11.7129,4.0,69.0,1864.8,5800,874,147,6821,0
3544,30.352,4.4,99.0,2117.6,4570,1992,238,6800,0
3545,16.59192308,5.0,52.84615385,998.0,2640,3951,200,6791,0
3546,33.70615385,6.153846154,120.1538462,1750.615385,5120,1345,271,6736,0
3547,59.4905,5.0,137.5,2734.5,5680,822,223,6725,0
3548,81.295,8.0,250.0,2998.0,5705,743,225,6673,0
3549,35.34,5.0,118.0,1781.0,5498,834,251,6583,0
3550,36.90769355,4.5,126.1451613,2344.0,5417,821,322,6560,0
3551,11.745,5.0,51.0,998.0,2951,3066,494,6511,0
3552,17.91985714,4.19047619,64.47619048,1759.190476,4785,1421,299,6505,0
3553,31.79107143,4.571428571,104.1428571,2211.071429,5194,982,304,6480,0
3554,14.76166667,4.666666667,75.0,1594.0,4072,2077,285,6434,0
3555,13.2053,6.0,35.8,679.0,3019,3003,375,6397,0
3556,36.01325,6.0,151.6666667,2048.666667,4745,1388,183,6316,0
3557,25.17006452,5.516129032,79.30645161,1523.741935,4265,1555,181,6001,1
3558,36.35965,4.55,110.5,2345.1,5030,720,239,5989,0
3559,14.333375,4.5625,59.875,1183.25,2433,3261,274,5968,0
3560,18.19842857,5.0,87.71428571,1696.428571,4009,1392,317,5718,0
3561,21.407,4.5,72.0,1974.0,3849,1511,278,5638,0
3562,76.71,0.0,336.0,0.0,4187,1098,208,5493,0
3563,43.9745,4.5,98.0,2309.0,3360,1797,297,5454,0
3564,38.48247059,4.882352941,90.94117647,2953.588235,4365,904,185,5454,1
3565,21.6,6.0,64.625,1496.0,2624,2408,157,5189,0
3566,108.7471951,7.853658537,207.6097561,2304.97561,3833,788,283,4904,1
3567,55.25,6.0,177.0,1997.0,3572,1036,255,4863,0
3568,116.545,8.0,230.0,2981.0,4221,322,220,4763,0
3569,20.74,5.0,75.0,1695.0,2876,1707,148,4731,0
3570,34.10357143,4.571428571,121.8571429,2555.285714,3791,615,236,4642,0
3571,55.2,6.0,163.5,2696.5,3007,1202,269,4478,0
3572,37.4265,6.2,104.2,1796.6,2421,1646,271,4338,0
3573,19.055,4.6,89.2,1827.8,3302,909,126,4337,0
3574,11.74,5.0,63.0,1405.0,2024,2008,159,4191,0
3575,60.87,6.75,228.0,1984.0,3289,686,184,4159,0
3576,76.5922,8.0,184.0,2396.4,2471,1388,234,4093,0
3577,30.081,4.0,110.0,2254.0,2681,1076,287,4044,0
3578,8.4656,4.6,41.4,1182.4,2945,858,155,3958,0
3579,17.42714286,5.0,87.71428571,1696.428571,2669,1033,202,3904,0
3580,69.397,5.0,173.0,3358.666667,3159,460,209,3828,0
3581,45.76307692,5.307692308,109.0769231,2053.0,2528,1077,213,3818,1
3582,30.92666667,4.666666667,110.3333333,2328.333333,2654,895,184,3733,0
3583,45.59125,5.25,104.1666667,2027.833333,2404,1108,146,3658,0
3584,38.72769231,5.538461538,114.6538462,2178.192308,2934,557,134,3625,1
3585,114.8758333,8.0,235.0,2979.0,3114,341,135,3590,0
3586,158.976,8.0,326.0,3295.0,2712,662,144,3518,0
3587,57.22905851,5.234042553,120.4255319,2309.340426,2526,766,216,3508,1
3588,28.379,4.6,91.6,2181.2,2756,585,124,3465,0
3589,46.60136364,6.0,110.0,2393.0,2700,515,142,3357,1
3590,27.935,5.0,103.5,1833.0,2086,1044,219,3349,0
3591,22.35277778,4.222222222,80.92592593,1977.259259,2699,502,132,3333,0
3592,24.35,6.0,60.0,698.0,2018,1112,167,3297,0
3593,48.09553571,5.107142857,117.7857143,2315.0,2774,378,121,3273,0
3594,39.725,6.8,110.0,1592.0,2681,335,182,3198,0
3595,17.5296,4.6,78.4,1549.8,2261,653,96,3010,0
3596,10.32442857,4.142857143,54.35714286,1463.857143,1769,1091,126,2986,0
3597,38.79428571,4.428571429,98.57142857,2755.571429,2220,598,109,2927,1
3598,46.5274,7.04,131.6,1596.92,2480,256,113,2849,0
3599,23.90933333,5.0,100.6666667,2016.777778,2355,362,109,2826,0
3600,11.63114286,4.428571429,47.14285714,1477.0,1690,758,76,2524,0
3601,134.789,8.0,390.0,4395.0,2268,137,97,2502,0
3602,35.25972727,4.727272727,104.6363636,2367.181818,2033,362,104,2499,0
3603,94.098125,8.0,190.0,2967.0,1764,549,104,2417,1
3604,158.823,4.5,250.0,3228.0,2126,191,92,2409,0
3605,95.29916667,6.333333333,253.6666667,3764.333333,2016,267,94,2377,0
3606,43.89111111,5.666666667,130.5555556,2457.555556,1971,257,119,2347,0
3607,12.25,5.0,43.0,1325.0,1538,703,81,2322,0
3608,55.4225,6.0,221.0,3498.0,1961,264,91,2316,0
3609,20.65665217,4.956521739,67.0,2234.26087,1689,459,123,2271,0
3610,38.025,4.5,129.5,2614.0,1486,692,92,2270,0
3611,38.39725,4.75,131.0,2652.375,1894,236,98,2228,0
3612,13.382,2.5,48.0,1343.0,725,1379,122,2226,0
3613,15.764,5.0,66.0,1497.0,1023,1069,109,2201,0
3614,33.798,0.0,96.0,1797.4,1495,496,208,2199,0
3615,23.16515789,3.947368421,82.15789474,1817.315789,1373,701,103,2177,0
3616,6.494,5.0,30.0,903.0,994,985,117,2096,0
3617,58.46907407,6.444444444,148.5185185,2174.037037,1493,370,157,2020,1
3618,10.9158,5.0,49.8,1372.4,1455,401,46,1902,0
3619,28.803,4.8,111.2,2126.8,1523,236,47,1806,0
3620,110.0985,5.0,235.0,4957.0,1598,120,69,1787,0
3621,111.993,5.0,220.0,4988.0,1541,163,71,1775,0
3622,12.924,4.0,43.0,989.0,734,889,100,1723,0
3623,44.62833333,4.333333333,127.6666667,3100.333333,1349,334,32,1715,1
3624,6.050333333,4.333333333,52.0,1335.0,1129,539,47,1715,0
3625,28.735,4.666666667,100.6666667,1590.0,1010,574,97,1681,0
3626,36.52419118,5.176470588,113.3529412,2106.5,1141,390,124,1655,0
3627,646.605,6.0,450.0,5733.0,1460,137,55,1652,0
3628,285.247,7.2,428.2,5577.8,1471,115,60,1646,0
3629,28.96891667,5.0,72.625,1707.125,975,529,97,1601,0
3630,41.59161538,6.461538462,111.3076923,1624.769231,1000,425,29,1454,0
3631,28.295,5.0,96.0,1747.0,960,354,84,1398,0
3632,17.82333333,4.666666667,70.33333333,1298.666667,736,612,49,1397,0
3633,93.42433333,5.0,233.0,2995.0,1295,59,39,1393,0
3634,45.78386047,4.813953488,106.3023256,2768.511628,1015,265,62,1342,1
3635,13.137,5.0,93.5,1998.0,1131,153,58,1342,0
3636,56.15916667,5.5,174.3333333,3199.0,953,285,44,1282,0
3637,12.61125,4.5,56.25,1607.25,968,247,44,1259,0
3638,37.44666667,2.611111111,120.3333333,2085.055556,850,325,63,1238,0
3639,61.235,5.0,147.0,2144.0,1040,121,42,1203,0
3640,35.29583333,5.0,102.0,2129.0,735,397,59,1191,0
3641,35.27,6.0,112.0714286,1574.428571,710,333,112,1155,0
3642,200.19825,6.0,294.0,3586.0,1039,52,40,1131,0
3643,17.182,5.0,74.0,1994.0,1012,71,30,1113,0
3644,107.7,5.0,274.0,3800.5,994,72,32,1098,0
3645,16.641,4.5,71.0,1590.0,352,629,64,1045,0
3646,71.187,5.0,239.0,4997.0,934,63,38,1035,0
3647,27.13,5.768421053,96.05263158,1774.778947,594,244,193,1031,1
3648,18.53214286,5.714285714,68.57142857,1166.142857,590482,657149,52404,1300035,0
3649,16.20874359,4.461538462,63.56410256,1650.205128,610738,290669,35505,936912,0
3650,39.97375,1.75,130.25,1998.5,576085,136421,24759,737265,0
3651,31.24215385,6.164835165,89.46153846,1537.406593,364608,232700,36934,634242,0
3652,22.1,5.615384615,75.57692308,1219.653846,238045,344752,25876,608673,0
3653,20.3776087,4.869565217,67.95652174,1279.695652,204065,327558,27614,559237,0
3654,30.61932203,5.966101695,94.03389831,1497.169492,311989,163596,16111,491696,0
3655,17.182,5.0,74.0,1994.0,299936,159312,19471,478719,0
3656,47.84837037,6.444444444,126.1111111,1995.777778,328418,116733,23758,468909,0
3657,18.1925,5.074074074,60.96296296,1408.055556,184240,251876,27477,463593,0
3658,26.4498867,5.408866995,87.31034483,1623.793103,236881,160893,17112,414886,0
3659,20.03375,4.833333333,71.33333333,1631.5,138652,220888,13905,373445,0
3660,18.64264,4.84,67.0,1698.64,214561,132300,15920,362781,0
3661,29.942625,4.5,106.225,1480.575,196423,122719,17596,336738,0
3662,12.35588235,4.647058824,53.88235294,1366.294118,123003,188788,14235,326026,0
3663,15.46,5.0,60.8,1196.0,79769,202062,13284,295115,0
3664,34.02059211,5.552631579,99.0,1920.026316,167529,45767,8271,221567,1
3665,27.23911864,3.033898305,91.61016949,1677.949153,128066,78732,12687,219485,0
3666,12.32981818,4.818181818,53.81818182,1367.272727,93329,117723,7462,218514,0
3667,28.60820513,4.756410256,92.82051282,2043.820513,153908,31806,7956,193670,0
3668,26.51269565,4.02173913,93.58695652,1933.021739,144343,38787,8638,191768,0
3669,22.36209302,4.88372093,72.58139535,1743.44186,116338,60413,5089,181840,0
3670,46.06451282,6.487179487,125.4358974,1835.846154,133010,31300,9103,173413,0
3671,13.11525,4.75,50.875,1430.75,86655,72865,8473,167993,0
3672,18.2955625,4.875,70.25,1836.5,133087,28619,4865,166571,0
3673,46.5274,7.04,131.6,1596.92,116043,33612,9362,159017,0
3674,22.78208333,4.916666667,81.66666667,1847.666667,95976,54394,6026,156396,0
3675,93.71425,8.0,225.0,2979.0,126010,20655,7204,153869,0
3676,20.43008333,4.791666667,69.875,1773.0,110812,27878,5709,144399,0
3677,107.4521429,8.0,182.5714286,2425.428571,108637,29397,6037,144071,1
3678,39.39984314,5.784313725,117.7058824,2151.647059,106868,24827,7655,139350,0
3679,20.7206,3.52,74.4,1397.8,49374,72916,10629,132919,0
3680,57.92693548,6.161290323,149.7096774,2283.112903,98320,25221,6528,130069,0
3681,17.44569231,4.692307692,68.26923077,1791.230769,92953,25549,6909,125411,0
3682,16.05676923,4.923076923,67.0,1703.153846,68584,37177,5475,111236,0
3683,10.83275,5.0,45.0,1242.0,47654,57545,5443,110642,0
3684,17.34364706,4.745098039,70.92156863,1683.607843,62143,41820,5331,109294,0
3685,24.84390244,4.756097561,84.92682927,1982.756098,84565,20109,4335,109009,0
3686,43.86363077,5.292307692,105.1692308,2083.523077,61155,34548,4993,100696,1
3687,78.07322727,7.672727273,192.4,2598.818182,76704,13858,5813,96375,0
3688,37.31523077,4.323076923,103.6769231,1873.261538,71642,17198,4764,93604,0
3689,27.46483636,4.872727273,86.45454545,1723.0,55092,34743,2825,92660,0
3690,15.40377778,5.0,60.11111111,1593.111111,57334,20118,2951,80403,0
3691,19.93814035,5.649122807,76.31578947,1205.192982,39704,36445,3530,79679,0
3692,14.293,4.6,75.4,1479.0,42012,30849,3124,75985,0
3693,20.27896296,4.111111111,72.85185185,1832.888889,50865,21350,3764,75979,0
3694,53.78571429,6.0,124.8571429,1855.0,48791,20150,3531,72472,1
3695,16.29053333,4.8,57.86666667,1645.133333,47118,21863,3275,72256,0
3696,26.803,5.428571429,85.71428571,1310.0,37336,29350,4385,71071,0
3697,17.22277778,4.888888889,70.0,1615.333333,40718,25788,3276,69782,0
3698,43.54851613,1.35483871,137.7741935,2261.193548,31894,32831,4844,69569,0
3699,11.370625,5.0,48.0,1518.0,41040,24872,2984,68896,0
3700,19.00794118,5.205882353,66.97058824,1292.352941,36625,25500,3123,65248,0
3701,31.1045119,4.547619048,93.01190476,1699.119048,28612,32340,3902,64854,0
3702,37.46857143,5.857142857,103.4285714,1718.571429,28504,29797,4196,62497,0
3703,18.84548718,4.076923077,87.07692308,2326.358974,51555,8023,1746,61324,0
3704,20.7195,4.71875,81.375,1950.90625,44080,11536,2616,58232,0
3705,14.350125,4.875,59.5,1642.875,37333,17350,2406,57089,0
3706,137.5695455,8.0,223.5454545,2813.0,48456,5052,2152,55660,0
3707,27.09825,4.666666667,91.75,2247.333333,42253,10603,2404,55260,0
3708,39.35238095,5.0,98.04761905,1928.714286,45278,7086,1881,54245,0
3709,23.322,3.75,84.2,1853.9,40595,10845,1503,52943,0
3710,35.28132353,5.176470588,113.3529412,2106.5,37541,11586,3032,52159,0
3711,50.96109091,6.181818182,135.2909091,1971.163636,38759,8988,3778,51525,1
3712,107.6705126,8.277310924,196.3361345,2521.092437,41210,7982,2140,51332,1
3713,37.00904545,4.590909091,114.6818182,2208.090909,35787,12082,3298,51167,0
3714,35.81481651,6.293577982,117.4311927,1921.46789,33850,13781,3382,51013,0
3715,31.38814286,6.714285714,111.0,1711.571429,23502,23276,3156,49934,0
3716,31.5255,5.166666667,109.6666667,1861.833333,33155,13397,2637,49189,0
3717,36.21929825,6.473684211,94.33333333,1424.666667,27472,17925,3234,48631,0
3718,30.3775,6.3125,94.0625,935.625,18522,27408,2660,48590,0
3719,11.28285714,4.285714286,49.28571429,1337.714286,23350,20858,2325,46533,0
3720,36.64326667,4.466666667,88.73333333,2284.133333,34896,8773,2383,46052,0
3721,59.0,7.0,166.0,1798.0,31417,11538,2334,45289,0
3722,82.06090909,7.727272727,199.7272727,2790.454545,36098,6548,2445,45091,1
3723,30.65053846,6.346153846,95.0,1136.692308,33693,7344,1681,42718,0
3724,14.4382,4.9,64.2,1891.7,31488,8867,1556,41911,0
3725,8.17,5.0,40.0,1108.0,13261,26551,1838,41650,0
3726,30.236875,4.5,110.0,2316.0,31521,7822,2091,41434,0
3727,7.712,5.0,29.0,899.0,14263,24663,2233,41159,0
3728,33.25025,6.166666667,112.75,1475.0,16226,22011,2565,40802,0
3729,49.28583333,6.0,145.0,1963.666667,27874,10100,2748,40722,0
3730,13.24516667,4.833333333,66.66666667,1506.5,21264,17176,1968,40408,0
3731,19.08518182,3.727272727,68.90909091,1180.545455,18054,19402,2679,40135,0
3732,22.90364865,5.405405405,75.64864865,1364.0,18659,20152,1077,39888,0
3733,36.38445588,4.5,125.7058824,2294.764706,30258,7086,2061,39405,0
3734,41.616,4.6,125.36,2336.52,29934,6230,2054,38218,0
3735,34.19,6.0,103.0,1794.0,25228,11111,1831,38170,0
3736,30.5976,1.8,97.6,1757.6,28971,7018,1748,37737,0
3737,22.455,6.0,92.30769231,1466.307692,20594,14902,1686,37182,0
3738,22.69,4.8,82.2,1773.7,25362,8115,1494,34971,0
3739,7.92,4.0,33.33333333,868.3333333,15011,17970,1548,34529,0
3740,72.79589474,6.210526316,166.3157895,3041.0,21042,7903,1693,30638,0
3741,11.389,4.142857143,53.0,1308.285714,10918,18065,1551,30534,0
3742,25.39952941,4.647058824,78.85294118,1891.588235,21506,6550,1296,29352,0
3743,66.58842105,5.736842105,172.3157895,2934.631579,24563,3460,1204,29227,0
3744,21.02333333,5.0,92.33333333,1729.333333,17681,9878,848,28407,0
3745,26.3525,0.0,80.0,1498.0,13160,14031,1063,28254,0
3746,23.585,5.8125,80.8125,1446.125,16468,10271,1512,28251,1
3747,115.533,8.0,250.0,2998.0,24197,2649,1286,28132,0
3748,65.56875,8.0,167.25,1998.0,22453,4512,1033,27998,0
3749,64.59222222,6.777777778,178.5555556,2011.555556,18167,7836,1860,27863,0
3750,16.4455,4.666666667,78.0,1741.0,18466,7969,1108,27543,0
3751,32.898125,5.333333333,116.2916667,2081.375,21351,4965,1181,27497,0
3752,62.39565385,4.384615385,135.5,2972.307692,20931,4734,1388,27053,0
3753,12.47666667,4.666666667,58.66666667,1498.0,15498,10106,1277,26881,0
3754,52.95719388,5.653061224,146.122449,2031.469388,21322,3486,1597,26405,0
3755,45.6995,6.0,114.0,1854.2,17069,6854,1651,25574,1
3756,43.08,4.666666667,105.0,2239.666667,16784,6970,1647,25401,0
3757,32.93965169,6.348314607,114.8202247,1615.370787,17575,6704,1063,25342,0
3758,9.8628,5.0,50.0,1090.4,12983,10131,1989,25103,0
3759,20.1241875,4.875,79.875,1836.875,17797,5990,1010,24797,0
3760,17.03876744,5.302325581,73.48837209,1374.046512,11352,12119,1238,24709,0
3761,7.863333333,5.0,44.0,1289.0,15703,7955,998,24656,0
3762,30.86290909,4.454545455,105.5454545,2458.909091,20350,3226,796,24372,0
3763,77.41666667,7.0,188.3333333,2876.0,15753,6352,1244,23349,1
3764,13.88308333,4.75,47.75,1373.75,7260,14801,1273,23334,0
3765,34.9090566,5.603773585,104.2264151,1805.924528,19460,3169,701,23330,1
3766,24.09525,6.25,68.75,1498.25,8094,13611,1526,23231,0
3767,20.35378947,4.789473684,67.68421053,1996.684211,16547,4715,946,22208,0
3768,27.4386,6.34,85.28,1452.0,14835,6517,658,22010,1
3769,37.01736842,4.736842105,97.57894737,2697.368421,15485,5627,829,21941,1
3770,27.78966667,4.666666667,110.6666667,2050.333333,14656,5413,1075,21144,0
3771,37.52210345,3.896551724,107.3793103,2084.37931,14747,4918,1437,21102,0
3772,61.86283333,6.833333333,184.1666667,2748.333333,9842,9496,1584,20922,0
3773,22.77681818,5.272727273,92.36363636,1837.363636,13245,6520,557,20322,0
3774,39.7374,4.6,115.0,2234.4,10594,8118,1338,20050,0
3775,158.7922667,7.466666667,293.5333333,3005.4,17236,1676,865,19777,0
3776,20.49710714,4.142857143,72.42857143,1824.428571,13821,5006,930,19757,0
3777,25.08266667,4.533333333,93.6,2127.333333,14773,3307,752,18832,0
3778,16.67175,4.5,74.0,1541.5,11429,5807,1011,18247,0
3779,10.42388889,5.0,52.44444444,1095.777778,8715,8457,917,18089,0
3780,20.37,5.642857143,74.21428571,1324.357143,13759,3647,672,18078,0
3781,9.358333333,4.333333333,47.0,1324.0,7989,9083,855,17927,0
3782,23.16515789,3.947368421,82.15789474,1817.315789,11104,5451,1069,17624,0
3783,19.37890909,4.863636364,61.27272727,1470.909091,10070,7070,356,17496,0
3784,39.70773684,4.842105263,117.5789474,2719.842105,11519,4925,799,17243,1
3785,25.94322222,4.777777778,67.0,1372.666667,6751,8385,1676,16812,0
3786,37.32636,4.76,101.12,2349.08,13286,2673,760,16719,0
3787,19.71783333,4.0,98.0,1995.0,10812,4721,676,16209,0
3788,83.50125,6.5,213.5,3071.0,12195,2898,1056,16149,0
3789,29.151,5.0,89.0,2526.5,11242,4210,637,16089,0
3790,107.6705126,8.277310924,196.3361345,2521.092437,13644,1746,504,15894,1
3791,113.2693333,8.0,246.3333333,2994.666667,11632,3458,665,15755,1
3792,43.06842105,6.254385965,104.2017544,2222.710526,13334,1361,989,15684,1
3793,49.82277778,6.0,115.8333333,1746.944444,10007,3886,903,14796,0
3794,22.95383333,5.0,67.33333333,1908.166667,9720,4175,743,14638,0
3795,13.70454545,4.818181818,47.45454545,1384.0,5304,8501,662,14467,0
3796,32.09,4.0,98.2,1754.4,6643,6750,758,14151,0
3797,9.5628,4.6,50.0,996.0,5583,7225,1330,14138,0
3798,30.0062,3.2,115.4666667,2245.6,11039,2315,708,14062,0
3799,32.723,3.6,96.0,1498.0,7283,5806,671,13760,0
3800,25.3433871,5.193548387,95.09677419,1802.774194,8344,4703,691,13738,0
3801,145.6466667,6.0,283.0,5000.0,11003,1786,620,13409,0
3802,135.1055,6.5,309.0,3999.0,11629,1263,475,13367,0
3803,16.80266667,4.5,71.0,1764.0,9908,2884,520,13312,0
3804,17.587,4.083333333,73.08333333,1363.5,8004,4651,597,13252,0
3805,24.84,5.0,102.0,2244.0,9627,2807,488,12922,0
3806,17.31241935,4.967741935,66.35483871,1655.741935,7952,3837,507,12296,0
3807,32.11766667,4.666666667,115.3333333,2362.0,8808,2721,444,11973,0
3808,50.94,6.266666667,138.2833333,1986.766667,9875,1147,697,11719,1
3809,47.361875,3.75,113.375,1774.8125,8462,2717,536,11715,1
3810,31.30566667,6.259259259,96.92592593,1587.222222,8382,2845,479,11706,0
3811,22.95871429,6.285714286,80.0,998.0,7316,3840,432,11588,0
3812,23.0525,5.0,55.0,1406.0,5700,4968,738,11406,0
3813,42.66935185,5.907407407,118.1851852,2095.185185,8919,1954,396,11269,0
3814,19.45142857,3.571428571,61.0,1197.0,5364,4693,1088,11145,0
3815,30.99,0.0,105.0,335.0,8674,2197,266,11137,0
3816,13.63642857,4.714285714,69.0,1424.857143,5775,5004,357,11136,0
3817,51.646,0.0,110.0,1995.0,7466,2844,822,11132,0
3818,29.88478947,4.736842105,109.1052632,2238.631579,6782,3765,522,11069,0
3819,52.085,8.0,223.8333333,1969.0,8858,1339,760,10957,0
3820,23.245,4.5,98.0,1998.0,8283,1982,419,10684,0
3821,25.2075,5.0,80.5,1753.0,6194,3530,566,10290,0
3822,18.76848837,4.860465116,67.02325581,1391.023256,5852,3816,447,10115,1
3823,23.16515789,3.947368421,82.15789474,1817.315789,6570,3103,410,10083,0
3824,264.675,7.0,420.0,6208.0,7422,2033,511,9966,0
3825,43.97,6.6,115.3,1634.2,5965,3490,379,9834,1
3826,22.127,5.0,83.0,1721.5,4975,4092,526,9593,0
3827,18.16715385,4.692307692,70.30769231,1932.153846,6696,2246,435,9377,0
3828,14.7754,4.8,51.4,1428.4,4446,4399,424,9269,0
3829,17.91985714,4.19047619,64.47619048,1759.190476,6580,2051,363,8994,0
3830,33.70615385,6.153846154,120.1538462,1750.615385,6528,1795,307,8630,0
3831,35.86943902,5.585365854,117.0243902,1980.634146,6711,1139,323,8173,0
3832,25.29875,4.5,94.0,1998.0,5022,2477,540,8039,0
3833,42.74666667,5.0,128.5,2548.833333,6876,930,227,8033,0
3834,11.7129,4.0,69.0,1864.8,6726,1060,168,7954,0
3835,13.191,5.0,51.33333333,1431.333333,3151,4391,400,7942,0
3836,15.16166667,4.666666667,75.0,1594.0,5559,2090,287,7936,0
3837,36.35965,4.55,110.5,2345.1,6617,991,323,7931,0
3838,29.57028571,5.0,84.0,1997.142857,5523,2008,394,7925,1
3839,44.14181818,6.545454545,144.6363636,2242.636364,5575,2067,248,7890,1
3840,11.745,5.0,51.0,998.0,3464,3732,538,7734,0
3841,28.9602,4.4,100.8,1936.6,5907,1412,374,7693,0
3842,40.7645,4.333333333,133.3333333,2634.222222,6103,1183,390,7676,0
3843,31.79107143,4.571428571,104.1428571,2211.071429,6176,1143,354,7673,0
3844,53.792,6.0,134.3333333,1730.0,6426,750,312,7488,0
3845,36.70125,4.875,91.75,2019.75,5099,2038,316,7453,0
3846,21.407,4.5,72.0,1974.0,5031,2031,353,7415,0
3847,52.19640625,5.3125,126.5,2323.9375,5227,1686,494,7407,0
3848,26.19775,4.625,77.0,1495.0,3481,3355,305,7141,0
3849,23.22409091,4.909090909,82.0,1938.0,4612,2192,284,7088,0
3850,81.295,8.0,250.0,2998.0,6017,796,235,7048,0
3851,59.4905,5.0,137.5,2734.5,5860,881,249,6990,0
3852,35.34,5.0,118.0,1781.0,5701,951,292,6944,0
3853,31.7425,4.833333333,119.6666667,2116.0,5407,1260,264,6931,0
3854,23.01661538,4.730769231,90.88461538,1709.538462,4580,1999,323,6902,0
3855,14.76166667,4.666666667,75.0,1594.0,4321,2111,264,6696,0
3856,20.36464286,5.857142857,82.25,1534.392857,4076,2278,147,6501,1
3857,36.90769355,4.5,126.1451613,2344.0,5354,785,318,6457,0
3858,18.19842857,5.0,87.71428571,1696.428571,4152,1475,336,5963,0
3859,76.71,0.0,336.0,0.0,4244,1146,195,5585,0
3860,14.333375,4.5625,59.875,1183.25,2349,2969,253,5571,0
3861,22.35277778,4.222222222,80.92592593,1977.259259,4540,834,192,5566,0
3862,43.9745,4.5,98.0,2309.0,3310,1826,283,5419,0
3863,38.48247059,4.882352941,90.94117647,2953.588235,4346,826,205,5377,1
3864,31.195,6.0,105.875,1755.75,3782,1399,131,5312,0
3865,18.513,4.6,76.0,1599.0,3261,1694,126,5081,0
3866,8.4656,4.6,41.4,1182.4,3590,1273,204,5067,0
3867,30.352,4.4,99.0,2117.6,3411,1421,205,5037,0
3868,18.88233333,4.666666667,74.0,1523.333333,3374,1336,326,5036,0
3869,34.10357143,4.571428571,121.8571429,2555.285714,4063,672,231,4966,0
3870,10.32442857,4.142857143,54.35714286,1463.857143,2675,1754,191,4620,0
3871,28.379,4.6,91.6,2181.2,3602,748,177,4527,0
3872,26.0,5.0,70.0,1597.0,1022,3300,120,4442,0
3873,11.63114286,4.428571429,47.14285714,1477.0,2855,1340,149,4344,0
3874,55.2,6.0,163.5,2696.5,2907,1167,245,4319,0
3875,69.397,5.0,173.0,3358.666667,3469,508,208,4185,0
3876,30.081,4.0,110.0,2254.0,2736,1100,291,4127,0
3877,17.42714286,5.0,87.71428571,1696.428571,2762,1121,201,4084,0
3878,25.17006452,5.516129032,79.30645161,1523.741935,2767,1092,123,3982,1
3879,116.545,8.0,230.0,2981.0,3474,269,198,3941,0
3880,17.5296,4.6,78.4,1549.8,2867,880,153,3900,0
3881,10.9158,5.0,49.8,1372.4,2845,920,114,3879,0
3882,30.92666667,4.666666667,110.3333333,2328.333333,2760,917,200,3877,0
3883,60.87,6.75,228.0,1984.0,3004,642,187,3833,0
3884,19.055,4.6,89.2,1827.8,2933,761,109,3803,0
3885,108.7471951,7.853658537,207.6097561,2304.97561,2964,548,282,3794,1
3886,32.06304348,5.956521739,89.34782609,1472.826087,2291,1370,107,3768,1
3887,55.25,6.0,177.0,1997.0,2792,737,185,3714,0
3888,20.65665217,4.956521739,67.0,2234.26087,2576,706,186,3468,0
3889,57.22905851,5.234042553,120.4255319,2309.340426,2404,799,237,3440,1
3890,35.25972727,4.727272727,104.6363636,2367.181818,2819,451,166,3436,0
3891,23.90933333,5.0,100.6666667,2016.777778,2694,430,122,3246,0
3892,64.109625,6.75,202.125,2778.0,2129,888,199,3216,0
3893,6.494,5.0,30.0,903.0,1467,1571,168,3206,0
3894,38.79428571,4.428571429,98.57142857,2755.571429,2280,642,115,3037,1
3895,38.39725,4.75,131.0,2652.375,2545,334,135,3014,0
3896,27.935,5.0,103.5,1833.0,1836,885,194,2915,0
3897,85.82946154,8.0,213.1538462,1969.0,1848,706,188,2742,0
3898,12.25,5.0,43.0,1325.0,1624,873,88,2585,0
3899,6.050333333,4.333333333,52.0,1335.0,1670,806,69,2545,0
3900,46.60136364,6.0,110.0,2393.0,2029,392,122,2543,1
3901,134.789,8.0,390.0,4395.0,2281,124,92,2497,0
3902,15.14,5.0,64.0,1382.75,1262,1176,55,2493,0
3903,46.5274,7.04,131.6,1596.92,2127,224,101,2452,0
3904,13.2053,6.0,35.8,679.0,1228,1075,146,2449,0
3905,23.16515789,3.947368421,82.15789474,1817.315789,1433,729,98,2260,0
3906,158.823,4.5,250.0,3228.0,1974,187,83,2244,0
3907,15.764,5.0,66.0,1497.0,1005,1133,102,2240,0
3908,36.01325,6.0,151.6666667,2048.666667,1641,475,88,2204,0
3909,48.09553571,5.107142857,117.7857143,2315.0,1847,230,71,2148,0
3910,13.382,2.5,48.0,1343.0,700,1323,110,2133,0
3911,43.89111111,5.666666667,130.5555556,2457.555556,1800,217,94,2111,0
3912,12.61125,4.5,56.25,1607.25,1594,418,80,2092,0
3913,45.76307692,5.307692308,109.0769231,2053.0,1229,504,94,1827,1
3914,110.0985,5.0,235.0,4957.0,1603,129,83,1815,0
3915,111.993,5.0,220.0,4988.0,1538,169,68,1775,0
3916,114.8758333,8.0,235.0,2979.0,1530,171,62,1763,0
3917,12.924,4.0,43.0,989.0,748,895,92,1735,0
3918,28.735,4.666666667,100.6666667,1590.0,1029,589,102,1720,0
3919,38.025,4.5,129.5,2614.0,1134,504,77,1715,0
3920,646.605,6.0,450.0,5733.0,1455,136,56,1647,0
3921,11.49625,4.75,50.25,1507.5,1024,530,65,1619,0
3922,45.59125,5.25,104.1666667,2027.833333,1029,458,55,1542,0
3923,95.29916667,6.333333333,253.6666667,3764.333333,1298,138,63,1499,0
3924,21.6,6.0,64.625,1496.0,767,679,52,1498,0
3925,39.725,6.8,110.0,1592.0,1293,155,42,1490,0
3926,93.42433333,5.0,233.0,2995.0,1361,60,44,1465,0
3927,13.137,5.0,93.5,1998.0,1201,183,61,1445,0
3928,13.818,5.0,66.0,1351.0,1057,256,62,1375,0
3929,20.74,5.0,75.0,1695.0,861,472,32,1365,0
3930,28.295,5.0,96.0,1747.0,933,338,82,1353,0
3931,61.235,5.0,147.0,2144.0,1122,109,48,1279,0
3932,158.976,8.0,326.0,3295.0,1026,187,60,1273,0
3933,17.182,5.0,74.0,1994.0,1112,84,27,1223,0
3934,11.9845625,4.0,69.0,1762.75,970,174,30,1174,0
3935,28.803,4.8,111.2,2126.8,997,125,36,1158,0
3936,15.6985,4.5,73.0,1590.0,711,346,64,1121,0
3937,32.98557692,6.230769231,94.03846154,1528.807692,678,359,83,1120,1
3938,92.798,4.0,166.0,3980.0,920,115,54,1089,0
3939,28.96891667,5.0,72.625,1707.125,636,385,65,1086,0
3940,35.27,6.0,112.0714286,1574.428571,671,300,95,1066,0
3941,16.641,4.5,71.0,1590.0,349,656,60,1065,0
3942,71.187,5.0,239.0,4997.0,948,67,43,1058,0
3943,71.602,4.0,149.0,3590.0,884,100,30,1014,0
3944,107.7,5.0,274.0,3800.5,927,60,26,1013,0
3945,29.043,5.851851852,105.0740741,1638.888889,889,96,27,1012,0
3946,58.46907407,6.444444444,148.5185185,2174.037037,780,160,69,1009,1
3947,18.53214286,5.714285714,68.57142857,1166.142857,620042,695180,50604,1365826,0
3948,16.20874359,4.461538462,63.56410256,1650.205128,700915,344765,36055,1081735,0
3949,39.97375,1.75,130.25,1998.5,551461,130545,20920,702926,0
3950,31.24215385,6.164835165,89.46153846,1537.406593,354091,226261,33723,614075,0
3951,20.3776087,4.869565217,67.95652174,1279.695652,207018,323686,25211,555915,0
3952,22.1,5.615384615,75.57692308,1219.653846,213815,314576,22070,550461,0
3953,17.182,5.0,74.0,1994.0,341789,175449,19120,536358,0
3954,18.1925,5.074074074,60.96296296,1408.055556,185207,246370,25529,457106,0
3955,47.84837037,6.444444444,126.1111111,1995.777778,300860,108101,20400,429361,0
3956,30.61932203,5.966101695,94.03389831,1497.169492,241175,124755,11332,377262,0
3957,26.4498867,5.408866995,87.31034483,1623.793103,209379,139892,13869,363140,0
3958,18.64264,4.84,67.0,1698.64,215205,133082,14344,362631,0
3959,12.35588235,4.647058824,53.88235294,1366.294118,121935,194705,12944,329584,0
3960,29.942625,4.5,106.225,1480.575,179729,116222,15205,311156,0
3961,20.03375,4.833333333,71.33333333,1631.5,115360,174027,9094,298481,0
3962,18.2955625,4.875,70.25,1836.5,197414,44606,6408,248428,0
3963,15.46,5.0,60.8,1196.0,68783,165918,10289,244990,0
3964,27.23911864,3.033898305,91.61016949,1677.949153,124731,76669,11238,212638,0
3965,12.32981818,4.818181818,53.81818182,1367.272727,90466,113467,6189,210122,0
3966,13.11525,4.75,50.875,1430.75,104785,92874,9742,207401,0
3967,34.02059211,5.552631579,99.0,1920.026316,156990,42366,6915,206271,1
3968,26.51269565,4.02173913,93.58695652,1933.021739,142409,38053,7392,187854,0
3969,20.43008333,4.791666667,69.875,1773.0,136766,34522,6239,177527,0
3970,28.60820513,4.756410256,92.82051282,2043.820513,136687,27865,6117,170669,0
3971,46.06451282,6.487179487,125.4358974,1835.846154,118149,27674,7533,153356,0
3972,93.71425,8.0,225.0,2979.0,121282,20487,6512,148281,0
3973,22.36209302,4.88372093,72.58139535,1743.44186,95606,48674,3567,147847,0
3974,17.44569231,4.692307692,68.26923077,1791.230769,101654,27651,6542,135847,0
3975,39.39984314,5.784313725,117.7058824,2151.647059,104375,24420,6815,135610,0
3976,107.4521429,8.0,182.5714286,2425.428571,102104,27625,5365,135094,1
3977,22.78208333,4.916666667,81.66666667,1847.666667,83129,46528,4633,134290,0
3978,46.5274,7.04,131.6,1596.92,98413,27008,7411,132832,0
3979,10.83275,5.0,45.0,1242.0,55507,70563,5833,131903,0
3980,15.40377778,5.0,60.11111111,1593.111111,86596,31575,3746,121917,0
3981,16.05676923,4.923076923,67.0,1703.153846,74603,40640,5474,120717,0
3982,24.84390244,4.756097561,84.92682927,1982.756098,88989,20930,4036,113955,0
3983,17.34364706,4.745098039,70.92156863,1683.607843,63201,43648,5095,111944,0
3984,57.92693548,6.161290323,149.7096774,2283.112903,81043,20330,5134,106507,0
3985,20.7206,3.52,74.4,1397.8,39190,53360,8183,100733,0
3986,16.29053333,4.8,57.86666667,1645.133333,58380,27988,3660,90028,0
3987,20.27896296,4.111111111,72.85185185,1832.888889,59078,24952,4039,88069,0
3988,18.84548718,4.076923077,87.07692308,2326.358974,73774,11810,2141,87725,0
3989,78.07322727,7.672727273,192.4,2598.818182,66289,12151,4835,83275,0
3990,43.86363077,5.292307692,105.1692308,2083.523077,49664,27844,3995,81503,1
3991,14.350125,4.875,59.5,1642.875,52084,25496,3065,80645,0
3992,14.293,4.6,75.4,1479.0,41777,30291,2641,74709,0
3993,19.93814035,5.649122807,76.31578947,1205.192982,36889,32657,3043,72589,0
3994,17.22277778,4.888888889,70.0,1615.333333,41991,25578,2677,70246,0
3995,11.370625,5.0,48.0,1518.0,42248,24861,2795,69904,0
3996,37.31523077,4.323076923,103.6769231,1873.261538,53446,12561,3182,69189,0
3997,11.28285714,4.285714286,49.28571429,1337.714286,32840,31119,3124,67083,0
3998,26.803,5.428571429,85.71428571,1310.0,34298,28063,3537,65898,0
3999,20.7195,4.71875,81.375,1950.90625,49636,12884,2619,65139,0
4000,27.09825,4.666666667,91.75,2247.333333,48383,12408,2486,63277,0
4001,53.78571429,6.0,124.8571429,1855.0,42557,17269,2830,62656,1
4002,14.4382,4.9,64.2,1891.7,45682,12949,2095,60726,0
4003,43.54851613,1.35483871,137.7741935,2261.193548,26442,26585,3769,56796,0
4004,137.5695455,8.0,223.5454545,2813.0,48611,5289,2031,55931,0
4005,37.00904545,4.590909091,114.6818182,2208.090909,38980,12991,3558,55529,0
4006,37.46857143,5.857142857,103.4285714,1718.571429,25157,25194,3577,53928,0
4007,36.64326667,4.466666667,88.73333333,2284.133333,38131,9812,2435,50378,0
4008,31.1045119,4.547619048,93.01190476,1699.119048,23083,23990,2968,50041,0
4009,30.3775,6.3125,94.0625,935.625,19872,26270,2438,48580,0
4010,19.00794118,5.205882353,66.97058824,1292.352941,27709,18375,2292,48376,0
4011,27.46483636,4.872727273,86.45454545,1723.0,29086,16689,1189,46964,0
4012,31.5255,5.166666667,109.6666667,1861.833333,31077,12469,2286,45832,0
4013,107.6705126,8.277310924,196.3361345,2521.092437,36627,7307,1771,45705,1
4014,35.28132353,5.176470588,113.3529412,2106.5,32612,9901,2743,45256,0
4015,59.0,7.0,166.0,1798.0,30840,11028,2204,44072,0
4016,7.712,5.0,29.0,899.0,14757,26917,2195,43869,0
4017,35.81481651,6.293577982,117.4311927,1921.46789,28955,11658,3105,43718,0
4018,41.616,4.6,125.36,2336.52,34244,7050,2190,43484,0
4019,30.236875,4.5,110.0,2316.0,32620,8133,2095,42848,0
4020,50.96109091,6.181818182,135.2909091,1971.163636,32090,7222,3421,42733,1
4021,19.08518182,3.727272727,68.90909091,1180.545455,18796,19953,2574,41323,0
4022,23.322,3.75,84.2,1853.9,32010,8197,1064,41271,0
4023,13.24516667,4.833333333,66.66666667,1506.5,21880,16466,1742,40088,0
4024,36.38445588,4.5,125.7058824,2294.764706,30713,7184,2052,39949,0
4025,39.35238095,5.0,98.04761905,1928.714286,32282,4795,1313,38390,0
4026,82.06090909,7.727272727,199.7272727,2790.454545,30607,5486,1986,38079,1
4027,36.21929825,6.473684211,94.33333333,1424.666667,21277,14118,2526,37921,0
4028,22.455,6.0,92.30769231,1466.307692,21230,15167,1479,37876,0
4029,23.585,5.8125,80.8125,1446.125,21974,14173,1709,37856,1
4030,7.92,4.0,33.33333333,868.3333333,15870,20226,1584,37680,0
4031,8.17,5.0,40.0,1108.0,12264,23672,1557,37493,0
4032,34.19,6.0,103.0,1794.0,24490,10621,1642,36753,0
4033,33.25025,6.166666667,112.75,1475.0,15193,17289,1966,34448,0
4034,20.35378947,4.789473684,67.68421053,1996.684211,24515,6999,1267,32781,0
4035,30.65053846,6.346153846,95.0,1136.692308,25715,5444,1287,32446,0
4036,49.28583333,6.0,145.0,1963.666667,21850,7989,2221,32060,0
4037,11.389,4.142857143,53.0,1308.285714,11369,18857,1493,31719,0
4038,30.5976,1.8,97.6,1757.6,23953,6192,1562,31707,0
4039,22.69,4.8,82.2,1773.7,22765,7136,1182,31083,0
4040,7.863333333,5.0,44.0,1289.0,19688,10065,1144,30897,0
4041,16.4455,4.666666667,78.0,1741.0,20036,8392,997,29425,0
4042,12.47666667,4.666666667,58.66666667,1498.0,16959,10923,1142,29024,0
4043,62.39565385,4.384615385,135.5,2972.307692,22135,5010,1367,28512,0
4044,115.533,8.0,250.0,2998.0,24045,2617,1198,27860,0
4045,10.42388889,5.0,52.44444444,1095.777778,12866,13344,1293,27503,0
4046,17.03876744,5.302325581,73.48837209,1374.046512,12086,12979,1274,26339,0
4047,30.86290909,4.454545455,105.5454545,2458.909091,21914,3349,802,26065,0
4048,31.38814286,6.714285714,111.0,1711.571429,13195,11027,1691,25913,0
4049,20.1241875,4.875,79.875,1836.875,17865,5841,857,24563,0
4050,43.08,4.666666667,105.0,2239.666667,15817,6590,1433,23840,0
4051,27.78966667,4.666666667,110.6666667,2050.333333,16102,6227,1139,23468,0
4052,20.49710714,4.142857143,72.42857143,1824.428571,16022,5781,1003,22806,0
4053,72.79589474,6.210526316,166.3157895,3041.0,15856,5684,1153,22693,0
4054,45.6995,6.0,114.0,1854.2,14968,5848,1469,22285,1
4055,25.39952941,4.647058824,78.85294118,1891.588235,16266,4942,948,22156,0
4056,66.58842105,5.736842105,172.3157895,2934.631579,18443,2526,890,21859,0
4057,52.95719388,5.653061224,146.122449,2031.469388,17547,2628,1299,21474,0
4058,37.52210345,3.896551724,107.3793103,2084.37931,14601,4919,1390,20910,0
4059,32.898125,5.333333333,116.2916667,2081.375,16172,3623,876,20671,0
4060,37.01736842,4.736842105,97.57894737,2697.368421,14574,5338,706,20618,1
4061,25.08266667,4.533333333,93.6,2127.333333,16018,3594,724,20336,0
4062,16.67175,4.5,74.0,1541.5,12868,6483,978,20329,0
4063,9.8628,5.0,50.0,1090.4,10643,8232,1373,20248,0
4064,37.32636,4.76,101.12,2349.08,16050,3316,840,20206,0
4065,64.59222222,6.777777778,178.5555556,2011.555556,13681,5094,1261,20036,0
4066,13.88308333,4.75,47.75,1373.75,6418,12550,1039,20007,0
4067,9.358333333,4.333333333,47.0,1324.0,8582,10209,871,19662,0
4068,39.7374,4.6,115.0,2234.4,10358,7737,1295,19390,0
4069,77.41666667,7.0,188.3333333,2876.0,12754,4917,921,18592,1
4070,107.6705126,8.277310924,196.3361345,2521.092437,15836,2228,484,18548,1
4071,23.16515789,3.947368421,82.15789474,1817.315789,11598,5797,985,18380,0
4072,20.37,5.642857143,74.21428571,1324.357143,13734,3644,593,17971,0
4073,61.86283333,6.833333333,184.1666667,2748.333333,8845,7688,1337,17870,0
4074,158.7922667,7.466666667,293.5333333,3005.4,14859,1410,683,16952,0
4075,32.93965169,6.348314607,114.8202247,1615.370787,11593,4342,707,16642,0
4076,31.30566667,6.259259259,96.92592593,1587.222222,11808,4027,651,16486,0
4077,65.56875,8.0,167.25,1998.0,13165,2567,587,16319,0
4078,30.0062,3.2,115.4666667,2245.6,12576,2654,750,15980,0
4079,29.151,5.0,89.0,2526.5,10838,3996,555,15389,0
4080,19.71783333,4.0,98.0,1995.0,10397,4260,610,15267,0
4081,22.95383333,5.0,67.33333333,1908.166667,10006,4344,649,14999,0
4082,21.02333333,5.0,92.33333333,1729.333333,9363,4866,406,14635,0
4083,27.4386,6.34,85.28,1452.0,9732,4339,394,14465,1
4084,16.80266667,4.5,71.0,1764.0,10946,3037,456,14439,0
4085,34.9090566,5.603773585,104.2264151,1805.924528,11936,1842,427,14205,1
4086,24.84,5.0,102.0,2244.0,10172,3018,447,13637,0
4087,17.587,4.083333333,73.08333333,1363.5,8356,4727,519,13602,0
4088,25.94322222,4.777777778,67.0,1372.666667,5412,6677,1196,13285,0
4089,43.06842105,6.254385965,104.2017544,2222.710526,11355,1129,798,13282,1
4090,24.09525,6.25,68.75,1498.25,5017,7239,938,13194,0
4091,83.50125,6.5,213.5,3071.0,9960,2241,768,12969,0
4092,39.70773684,4.842105263,117.5789474,2719.842105,8659,3517,593,12769,1
4093,49.82277778,6.0,115.8333333,1746.944444,8575,3145,751,12471,0
4094,22.90364865,5.405405405,75.64864865,1364.0,6217,5978,241,12436,0
4095,13.70454545,4.818181818,47.45454545,1384.0,4676,7049,544,12269,0
4096,32.723,3.6,96.0,1498.0,6531,5143,552,12226,0
4097,17.31241935,4.967741935,66.35483871,1655.741935,7975,3776,471,12222,0
4098,145.6466667,6.0,283.0,5000.0,9754,1530,524,11808,0
4099,17.91985714,4.19047619,64.47619048,1759.190476,8484,2851,422,11757,0
4100,26.3525,0.0,80.0,1498.0,5781,5563,379,11723,0
4101,33.70615385,6.153846154,120.1538462,1750.615385,8542,2505,392,11439,0
4102,32.11766667,4.666666667,115.3333333,2362.0,8421,2546,381,11348,0
4103,23.245,4.5,98.0,1998.0,8343,1867,349,10559,0
4104,36.35965,4.55,110.5,2345.1,8393,1286,360,10039,0
4105,22.127,5.0,83.0,1721.5,5085,4285,496,9866,0
4106,18.16715385,4.692307692,70.30769231,1932.153846,7064,2309,424,9797,0
4107,135.1055,6.5,309.0,3999.0,8484,944,327,9755,0
4108,11.7129,4.0,69.0,1864.8,8078,1404,186,9668,0
4109,9.5628,4.6,50.0,996.0,3577,5331,567,9475,0
4110,21.407,4.5,72.0,1974.0,6456,2615,397,9468,0
4111,25.3433871,5.193548387,95.09677419,1802.774194,5774,3062,441,9277,0
4112,113.2693333,8.0,246.3333333,2994.666667,6758,1999,381,9138,1
4113,35.86943902,5.585365854,117.0243902,1980.634146,7518,1303,310,9131,0
4114,11.745,5.0,51.0,998.0,3956,4376,613,8945,0
4115,22.35277778,4.222222222,80.92592593,1977.259259,7138,1421,278,8837,0
4116,13.191,5.0,51.33333333,1431.333333,3417,4868,430,8715,0
4117,31.79107143,4.571428571,104.1428571,2211.071429,7022,1220,365,8607,0
4118,43.97,6.6,115.3,1634.2,5246,3038,317,8601,1
4119,51.646,0.0,110.0,1995.0,5717,2164,656,8537,0
4120,18.76848837,4.860465116,67.02325581,1391.023256,4933,3226,342,8501,1
4121,50.94,6.266666667,138.2833333,1986.766667,7134,761,561,8456,1
4122,14.7754,4.8,51.4,1428.4,4182,3913,330,8425,0
4123,23.0525,5.0,55.0,1406.0,4363,3455,522,8340,0
4124,25.2075,5.0,80.5,1753.0,5040,2744,370,8154,0
4125,40.7645,4.333333333,133.3333333,2634.222222,6335,1223,373,7931,0
4126,28.9602,4.4,100.8,1936.6,6100,1475,343,7918,0
4127,29.88478947,4.736842105,109.1052632,2238.631579,4851,2635,377,7863,0
4128,11.63114286,4.428571429,47.14285714,1477.0,4939,2464,291,7694,0
4129,23.01661538,4.730769231,90.88461538,1709.538462,5034,2298,326,7658,0
4130,25.29875,4.5,94.0,1998.0,4828,2332,470,7630,0
4131,81.295,8.0,250.0,2998.0,6414,904,231,7549,0
4132,19.45142857,3.571428571,61.0,1197.0,3571,3068,710,7349,0
4133,264.675,7.0,420.0,6208.0,5405,1591,340,7336,0
4134,29.57028571,5.0,84.0,1997.142857,5133,1846,335,7314,1
4135,59.4905,5.0,137.5,2734.5,6006,1024,278,7308,0
4136,35.34,5.0,118.0,1781.0,5891,1051,280,7222,0
4137,10.9158,5.0,49.8,1372.4,5242,1778,194,7214,0
4138,10.32442857,4.142857143,54.35714286,1463.857143,4126,2657,284,7067,0
4139,15.16166667,4.666666667,75.0,1594.0,4941,1795,225,6961,0
4140,53.792,6.0,134.3333333,1730.0,5958,689,290,6937,0
4141,30.99,0.0,105.0,335.0,5471,1274,180,6925,0
4142,31.7425,4.833333333,119.6666667,2116.0,5449,1226,239,6914,0
4143,14.76166667,4.666666667,75.0,1594.0,4521,2117,213,6851,0
4144,22.77681818,5.272727273,92.36363636,1837.363636,4448,1951,154,6553,0
4145,8.4656,4.6,41.4,1182.4,4450,1796,254,6500,0
4146,23.16515789,3.947368421,82.15789474,1817.315789,4194,2022,266,6482,0
4147,52.085,8.0,223.8333333,1969.0,5037,726,634,6397,0
4148,36.70125,4.875,91.75,2019.75,4385,1733,272,6390,0
4149,32.09,4.0,98.2,1754.4,3152,2786,305,6243,0
4150,36.90769355,4.5,126.1451613,2344.0,5198,732,305,6235,0
4151,18.19842857,5.0,87.71428571,1696.428571,4155,1503,290,5948,0
4152,22.95871429,6.285714286,80.0,998.0,3791,1935,220,5946,0
4153,26.19775,4.625,77.0,1495.0,2939,2757,247,5943,0
4154,28.379,4.6,91.6,2181.2,4566,958,186,5710,0
4155,23.22409091,4.909090909,82.0,1938.0,3608,1724,207,5539,0
4156,76.71,0.0,336.0,0.0,4187,1154,196,5537,0
4157,38.48247059,4.882352941,90.94117647,2953.588235,4446,870,183,5499,1
4158,52.19640625,5.3125,126.5,2323.9375,3915,1072,429,5416,0
4159,34.10357143,4.571428571,121.8571429,2555.285714,4329,718,214,5261,0
4160,43.9745,4.5,98.0,2309.0,3135,1844,269,5248,0
4161,17.5296,4.6,78.4,1549.8,3639,1320,234,5193,0
4162,20.65665217,4.956521739,67.0,2234.26087,3734,1113,269,5116,0
4163,47.361875,3.75,113.375,1774.8125,3715,1143,166,5024,1
4164,14.333375,4.5625,59.875,1183.25,2174,2516,210,4900,0
4165,6.494,5.0,30.0,903.0,2016,2390,190,4596,0
4166,69.397,5.0,173.0,3358.666667,3786,548,213,4547,0
4167,35.25972727,4.727272727,104.6363636,2367.181818,3612,605,187,4404,0
4168,55.2,6.0,163.5,2696.5,2859,1138,240,4237,0
4169,17.42714286,5.0,87.71428571,1696.428571,2836,1172,211,4219,0
4170,44.14181818,6.545454545,144.6363636,2242.636364,3028,1072,111,4211,1
4171,30.081,4.0,110.0,2254.0,2677,1124,279,4080,0
4172,30.92666667,4.666666667,110.3333333,2328.333333,2926,924,193,4043,0
4173,42.74666667,5.0,128.5,2548.833333,3343,408,140,3891,0
4174,38.39725,4.75,131.0,2652.375,3213,474,155,3842,0
4175,6.050333333,4.333333333,52.0,1335.0,2481,1230,104,3815,0
4176,23.90933333,5.0,100.6666667,2016.777778,3002,486,121,3609,0
4177,12.61125,4.5,56.25,1607.25,2621,737,128,3486,0
4178,20.36464286,5.857142857,82.25,1534.392857,2100,1332,37,3469,1
4179,30.352,4.4,99.0,2117.6,2343,969,136,3448,0
4180,42.66935185,5.907407407,118.1851852,2095.185185,2748,579,115,3442,0
4181,116.545,8.0,230.0,2981.0,3035,226,159,3420,0
4182,60.87,6.75,228.0,1984.0,2428,554,155,3137,0
4183,57.22905851,5.234042553,120.4255319,2309.340426,2229,671,208,3108,1
4184,38.79428571,4.428571429,98.57142857,2755.571429,2338,651,114,3103,1
4185,12.25,5.0,43.0,1325.0,1715,1070,102,2887,0
4186,18.88233333,4.666666667,74.0,1523.333333,1984,696,167,2847,0
4187,11.49625,4.75,50.25,1507.5,1827,855,106,2788,0
4188,55.25,6.0,177.0,1997.0,2026,488,124,2638,0
4189,31.195,6.0,105.875,1755.75,1812,734,67,2613,0
4190,19.055,4.6,89.2,1827.8,2042,484,82,2608,0
4191,108.7471951,7.853658537,207.6097561,2304.97561,2024,361,169,2554,1
4192,134.789,8.0,390.0,4395.0,2239,123,74,2436,0
4193,23.16515789,3.947368421,82.15789474,1817.315789,1471,736,100,2307,0
4194,18.513,4.6,76.0,1599.0,1498,748,57,2303,0
4195,15.764,5.0,66.0,1497.0,1011,1164,113,2288,0
4196,13.382,2.5,48.0,1343.0,733,1287,106,2126,0
4197,19.37890909,4.863636364,61.27272727,1470.909091,1248,826,49,2123,0
4198,13.818,5.0,66.0,1351.0,1640,385,77,2102,0
4199,46.5274,7.04,131.6,1596.92,1726,179,77,1982,0
4200,27.935,5.0,103.5,1833.0,1269,579,125,1973,0
4201,25.17006452,5.516129032,79.30645161,1523.741935,1369,549,54,1972,1
4202,114.8758333,8.0,235.0,2979.0,1648,208,69,1925,0
4203,158.823,4.5,250.0,3228.0,1665,155,74,1894,0
4204,110.0985,5.0,235.0,4957.0,1650,152,72,1874,0
4205,111.993,5.0,220.0,4988.0,1519,183,80,1782,0
4206,12.924,4.0,43.0,989.0,779,907,88,1774,0
4207,28.735,4.666666667,100.6666667,1590.0,1051,608,98,1757,0
4208,43.89111111,5.666666667,130.5555556,2457.555556,1412,143,69,1624,0
4209,646.605,6.0,450.0,5733.0,1407,142,55,1604,0
4210,11.9845625,4.0,69.0,1762.75,1298,254,34,1586,0
4211,13.137,5.0,93.5,1998.0,1254,218,61,1533,0
4212,93.42433333,5.0,233.0,2995.0,1331,58,39,1428,0
4213,15.6985,4.5,73.0,1590.0,908,440,78,1426,0
4214,46.60136364,6.0,110.0,2393.0,1105,202,63,1370,1
4215,17.182,5.0,74.0,1994.0,1231,101,32,1364,0
4216,28.295,5.0,96.0,1747.0,921,323,80,1324,0
4217,61.235,5.0,147.0,2144.0,1161,119,38,1318,0
4218,21.01833333,4.666666667,66.0,1206.0,1003,263,48,1314,0
4219,11.81928571,4.619047619,56.85714286,1520.952381,852,395,35,1282,0
4220,3.781,4.0,18.0,652.0,613,600,52,1265,0
4221,29.043,5.851851852,105.0740741,1638.888889,1084,148,30,1262,0
4222,71.602,4.0,149.0,3590.0,1088,122,45,1255,0
4223,9.999666667,4.333333333,49.33333333,1347.666667,820,340,51,1211,0
4224,92.798,4.0,166.0,3980.0,989,118,57,1164,0
4225,16.641,4.5,71.0,1590.0,365,701,58,1124,0
4226,12.241,5.0,57.0,1568.0,902,178,25,1105,0
4227,11.263,4.5,55.0,1597.0,878,173,33,1084,0
4228,71.187,5.0,239.0,4997.0,972,71,35,1078,0
4229,13.63642857,4.714285714,69.0,1424.857143,594,443,33,1070,0
4230,95.29916667,6.333333333,253.6666667,3764.333333,918,98,51,1067,0
4231,11.34,4.0,74.0,1985.0,825,200,40,1065,0
4232,48.09553571,5.107142857,117.7857143,2315.0,890,106,36,1032,0
4233,18.53214286,5.714285714,68.57142857,1166.142857,645772,722806,49373,1417951,0
4234,16.20874359,4.461538462,63.56410256,1650.205128,782270,394048,36882,1213200,0
4235,39.97375,1.75,130.25,1998.5,502075,117447,17634,637156,0
4236,17.182,5.0,74.0,1994.0,378257,185408,19163,582828,0
4237,31.24215385,6.164835165,89.46153846,1537.406593,333087,214731,30875,578693,0
4238,20.3776087,4.869565217,67.95652174,1279.695652,208418,321343,23564,553325,0
4239,22.1,5.615384615,75.57692308,1219.653846,182796,277598,18629,479023,0
4240,18.1925,5.074074074,60.96296296,1408.055556,185546,240752,23757,450055,0
4241,47.84837037,6.444444444,126.1111111,1995.777778,274268,100106,17871,392245,0
4242,18.64264,4.84,67.0,1698.64,205015,128124,12989,346128,0
4243,18.2955625,4.875,70.25,1836.5,273881,63170,8226,345277,0
4244,12.35588235,4.647058824,53.88235294,1366.294118,114498,186368,11715,312581,0
4245,26.4498867,5.408866995,87.31034483,1623.793103,176132,114714,11454,302300,0
4246,29.942625,4.5,106.225,1480.575,162144,109116,13437,284697,0
4247,30.61932203,5.966101695,94.03389831,1497.169492,161465,81100,7182,249747,0
4248,13.11525,4.75,50.875,1430.75,120165,112306,11058,243529,0
4249,20.43008333,4.791666667,69.875,1773.0,160393,40370,6668,207431,0
4250,20.03375,4.833333333,71.33333333,1631.5,82389,117756,5505,205650,0
4251,27.23911864,3.033898305,91.61016949,1677.949153,120427,74225,9816,204468,0
4252,15.46,5.0,60.8,1196.0,54731,124205,7807,186743,0
4253,12.32981818,4.818181818,53.81818182,1367.272727,80682,98186,5110,183978,0
4254,34.02059211,5.552631579,99.0,1920.026316,138988,36846,5684,181518,1
4255,26.51269565,4.02173913,93.58695652,1933.021739,134797,35874,6526,177197,0
4256,15.40377778,5.0,60.11111111,1593.111111,120347,44410,4550,169307,0
4257,10.83275,5.0,45.0,1242.0,62117,81046,6190,149353,0
4258,17.44569231,4.692307692,68.26923077,1791.230769,108374,29157,6480,144011,0
4259,28.60820513,4.756410256,92.82051282,2043.820513,112547,22558,4785,139890,0
4260,93.71425,8.0,225.0,2979.0,113396,19493,5870,138759,0
4261,46.06451282,6.487179487,125.4358974,1835.846154,102202,24220,6443,132865,0
4262,39.39984314,5.784313725,117.7058824,2151.647059,100555,23901,6252,130708,0
4263,16.05676923,4.923076923,67.0,1703.153846,78576,42312,5469,126357,0
4264,107.4521429,8.0,182.5714286,2425.428571,93923,25027,4827,123777,1
4265,18.84548718,4.076923077,87.07692308,2326.358974,99926,16038,2706,118670,0
4266,24.84390244,4.756097561,84.92682927,1982.756098,89849,20790,4015,114654,0
4267,17.34364706,4.745098039,70.92156863,1683.607843,64282,45210,5020,114512,0
4268,46.5274,7.04,131.6,1596.92,78802,20884,5760,105446,0
4269,14.350125,4.875,59.5,1642.875,67270,34212,3779,105261,0
4270,22.78208333,4.916666667,81.66666667,1847.666667,65661,35973,3605,105239,0
4271,16.29053333,4.8,57.86666667,1645.133333,67882,32332,3803,104017,0
4272,22.36209302,4.88372093,72.58139535,1743.44186,64366,32355,2355,99076,0
4273,20.27896296,4.111111111,72.85185185,1832.888889,65256,27397,4381,97034,0
4274,11.28285714,4.285714286,49.28571429,1337.714286,42883,42953,3902,89738,0
4275,57.92693548,6.161290323,149.7096774,2283.112903,63362,15830,4020,83212,0
4276,14.4382,4.9,64.2,1891.7,61336,17258,2601,81195,0
4277,20.7206,3.52,74.4,1397.8,29273,36415,5772,71460,0
4278,78.07322727,7.672727273,192.4,2598.818182,56582,10567,4080,71229,0
4279,11.370625,5.0,48.0,1518.0,43885,24197,2690,70772,0
4280,27.09825,4.666666667,91.75,2247.333333,53825,13941,2585,70351,0
4281,20.7195,4.71875,81.375,1950.90625,53073,13775,2533,69381,0
4282,14.293,4.6,75.4,1479.0,38839,27605,2256,68700,0
4283,19.93814035,5.649122807,76.31578947,1205.192982,35237,30532,2698,68467,0
4284,17.22277778,4.888888889,70.0,1615.333333,39488,22989,2275,64752,0
4285,26.803,5.428571429,85.71428571,1310.0,31165,26240,2628,60033,0
4286,37.00904545,4.590909091,114.6818182,2208.090909,42062,13678,3824,59564,0
4287,43.86363077,5.292307692,105.1692308,2083.523077,35860,19827,2733,58420,1
4288,137.5695455,8.0,223.5454545,2813.0,47920,5427,2036,55383,0
4289,36.64326667,4.466666667,88.73333333,2284.133333,40406,10784,2466,53656,0
4290,53.78571429,6.0,124.8571429,1855.0,34834,14523,2389,51746,1
4291,37.31523077,4.323076923,103.6769231,1873.261538,39696,9030,2195,50921,0
4292,41.616,4.6,125.36,2336.52,37419,7579,2423,47421,0
4293,37.46857143,5.857142857,103.4285714,1718.571429,22114,21700,3149,46963,0
4294,23.585,5.8125,80.8125,1446.125,26993,17615,2022,46630,1
4295,7.712,5.0,29.0,899.0,15125,28108,2158,45391,0
4296,20.35378947,4.789473684,67.68421053,1996.684211,33281,9821,1658,44760,0
4297,43.54851613,1.35483871,137.7741935,2261.193548,20289,20420,2793,43502,0
4298,30.236875,4.5,110.0,2316.0,32968,8158,2116,43242,0
4299,31.5255,5.166666667,109.6666667,1861.833333,28994,11311,1984,42289,0
4300,30.3775,6.3125,94.0625,935.625,18463,21277,2009,41749,0
4301,59.0,7.0,166.0,1798.0,28789,10070,2037,40896,0
4302,7.92,4.0,33.33333333,868.3333333,16854,22126,1593,40573,0
4303,107.6705126,8.277310924,196.3361345,2521.092437,32159,6454,1548,40161,1
4304,36.38445588,4.5,125.7058824,2294.764706,30418,7030,2141,39589,0
4305,10.42388889,5.0,52.44444444,1095.777778,17671,19410,1655,38736,0
4306,19.08518182,3.727272727,68.90909091,1180.545455,17357,18681,1690,37728,0
4307,22.455,6.0,92.30769231,1466.307692,20961,14403,1390,36754,0
4308,35.28132353,5.176470588,113.3529412,2106.5,26566,7792,2263,36621,0
4309,7.863333333,5.0,44.0,1289.0,23281,12028,1197,36506,0
4310,13.24516667,4.833333333,66.66666667,1506.5,20331,14408,1474,36213,0
4311,34.19,6.0,103.0,1794.0,23315,10288,1535,35138,0
4312,31.1045119,4.547619048,93.01190476,1699.119048,16910,16074,1959,34943,0
4313,35.81481651,6.293577982,117.4311927,1921.46789,23021,9212,2624,34857,0
4314,11.389,4.142857143,53.0,1308.285714,11922,19147,1419,32488,0
4315,50.96109091,6.181818182,135.2909091,1971.163636,24056,5256,2638,31950,1
4316,16.4455,4.666666667,78.0,1741.0,21331,8495,898,30724,0
4317,82.06090909,7.727272727,199.7272727,2790.454545,24339,4250,1594,30183,1
4318,12.47666667,4.666666667,58.66666667,1498.0,18034,11066,1073,30173,0
4319,8.17,5.0,40.0,1108.0,10127,18766,1214,30107,0
4320,36.21929825,6.473684211,94.33333333,1424.666667,16794,10997,2054,29845,0
4321,62.39565385,4.384615385,135.5,2972.307692,22919,5369,1401,29689,0
4322,33.25025,6.166666667,112.75,1475.0,14207,13643,1585,29435,0
4323,19.00794118,5.205882353,66.97058824,1292.352941,17231,10843,1330,29404,0
4324,23.322,3.75,84.2,1853.9,22572,5595,726,28893,0
4325,17.03876744,5.302325581,73.48837209,1374.046512,12788,13423,1210,27421,0
4326,115.533,8.0,250.0,2998.0,22867,2635,1124,26626,0
4327,30.5976,1.8,97.6,1757.6,19626,5378,1411,26415,0
4328,30.86290909,4.454545455,105.5454545,2458.909091,22198,3254,811,26263,0
4329,22.69,4.8,82.2,1773.7,19041,5845,950,25836,0
4330,27.78966667,4.666666667,110.6666667,2050.333333,17283,7252,1182,25717,0
4331,20.49710714,4.142857143,72.42857143,1824.428571,17668,6151,1023,24842,0
4332,39.35238095,5.0,98.04761905,1928.714286,20545,2855,813,24213,0
4333,37.32636,4.76,101.12,2349.08,19260,3866,949,24075,0
4334,49.28583333,6.0,145.0,1963.666667,15637,5575,1639,22851,0
4335,20.1241875,4.875,79.875,1836.875,16032,5244,737,22013,0
4336,43.08,4.666666667,105.0,2239.666667,14588,5996,1316,21900,0
4337,31.30566667,6.259259259,96.92592593,1587.222222,15569,5424,879,21872,0
4338,30.65053846,6.346153846,95.0,1136.692308,17336,3604,871,21811,0
4339,16.67175,4.5,74.0,1541.5,13912,6824,964,21700,0
4340,107.6705126,8.277310924,196.3361345,2521.092437,17857,2758,548,21163,1
4341,25.08266667,4.533333333,93.6,2127.333333,16581,3748,737,21066,0
4342,9.358333333,4.333333333,47.0,1324.0,9090,10761,862,20713,0
4343,37.52210345,3.896551724,107.3793103,2084.37931,13938,4768,1411,20117,0
4344,37.01736842,4.736842105,97.57894737,2697.368421,13161,4824,630,18615,1
4345,23.16515789,3.947368421,82.15789474,1817.315789,11736,5825,999,18560,0
4346,45.6995,6.0,114.0,1854.2,12080,4804,1204,18088,1
4347,39.7374,4.6,115.0,2234.4,9486,6869,1150,17505,0
4348,20.37,5.642857143,74.21428571,1324.357143,13338,3562,555,17455,0
4349,30.0062,3.2,115.4666667,2245.6,13682,2960,799,17441,0
4350,72.79589474,6.210526316,166.3157895,3041.0,11850,4054,837,16741,0
4351,25.39952941,4.647058824,78.85294118,1891.588235,11658,3417,646,15721,0
4352,13.88308333,4.75,47.75,1373.75,5052,9457,782,15291,0
4353,9.8628,5.0,50.0,1090.4,8154,6324,688,15166,0
4354,16.80266667,4.5,71.0,1764.0,11607,3085,442,15134,0
4355,22.95383333,5.0,67.33333333,1908.166667,10092,4356,629,15077,0
4356,33.70615385,6.153846154,120.1538462,1750.615385,11117,3374,510,15001,0
4357,66.58842105,5.736842105,172.3157895,2934.631579,12671,1662,607,14940,0
4358,32.898125,5.333333333,116.2916667,2081.375,11810,2442,652,14904,0
4359,61.86283333,6.833333333,184.1666667,2748.333333,7597,5904,1022,14523,0
4360,29.151,5.0,89.0,2526.5,10089,3743,477,14309,0
4361,158.7922667,7.466666667,293.5333333,3005.4,12464,1221,575,14260,0
4362,24.84,5.0,102.0,2244.0,10459,3210,442,14111,0
4363,52.95719388,5.653061224,146.122449,2031.469388,11485,1622,893,14000,0
4364,17.91985714,4.19047619,64.47619048,1759.190476,10102,3408,466,13976,0
4365,19.71783333,4.0,98.0,1995.0,9579,3669,484,13732,0
4366,17.587,4.083333333,73.08333333,1363.5,8506,4682,498,13686,0
4367,22.35277778,4.222222222,80.92592593,1977.259259,10777,2135,409,13321,0
4368,27.46483636,4.872727273,86.45454545,1723.0,8594,3984,241,12819,0
4369,11.63114286,4.428571429,47.14285714,1477.0,7999,4166,453,12618,0
4370,77.41666667,7.0,188.3333333,2876.0,8595,3251,611,12457,1
4371,11.7129,4.0,69.0,1864.8,10250,1847,231,12328,0
4372,17.31241935,4.967741935,66.35483871,1655.741935,8162,3689,422,12273,0
4373,36.35965,4.55,110.5,2345.1,10143,1568,439,12150,0
4374,64.59222222,6.777777778,178.5555556,2011.555556,8455,2767,712,11934,0
4375,10.9158,5.0,49.8,1372.4,8438,3078,329,11845,0
4376,21.407,4.5,72.0,1974.0,7777,3209,454,11440,0
4377,43.06842105,6.254385965,104.2017544,2222.710526,9064,942,635,10641,1
4378,11.745,5.0,51.0,998.0,4474,5062,714,10250,0
4379,10.32442857,4.142857143,54.35714286,1463.857143,5926,3965,352,10243,0
4380,32.11766667,4.666666667,115.3333333,2362.0,7636,2247,309,10192,0
4381,35.86943902,5.585365854,117.0243902,1980.634146,8314,1491,336,10141,0
4382,83.50125,6.5,213.5,3071.0,7814,1694,567,10075,0
4383,18.16715385,4.692307692,70.30769231,1932.153846,7310,2297,421,10028,0
4384,145.6466667,6.0,283.0,5000.0,8178,1230,421,9829,0
4385,22.127,5.0,83.0,1721.5,4994,4362,472,9828,0
4386,49.82277778,6.0,115.8333333,1746.944444,6717,2358,611,9686,0
4387,13.70454545,4.818181818,47.45454545,1384.0,3820,5445,416,9681,0
4388,32.723,3.6,96.0,1498.0,5169,3996,420,9585,0
4389,25.94322222,4.777777778,67.0,1372.666667,3952,5015,562,9529,0
4390,13.191,5.0,51.33333333,1431.333333,3627,5314,439,9380,0
4391,23.245,4.5,98.0,1998.0,7440,1541,305,9286,0
4392,31.79107143,4.571428571,104.1428571,2211.071429,7475,1283,364,9122,0
4393,32.93965169,6.348314607,114.8202247,1615.370787,6210,2316,390,8916,0
4394,9.5628,4.6,50.0,996.0,3347,5161,359,8867,0
4395,23.01661538,4.730769231,90.88461538,1709.538462,5642,2592,343,8577,0
4396,39.70773684,4.842105263,117.5789474,2719.842105,5759,2259,407,8425,1
4397,81.295,8.0,250.0,2998.0,6838,1044,256,8138,0
4398,8.4656,4.6,41.4,1182.4,5206,2500,302,8008,0
4399,40.7645,4.333333333,133.3333333,2634.222222,6372,1182,381,7935,0
4400,28.9602,4.4,100.8,1936.6,6115,1428,336,7879,0
4401,43.97,6.6,115.3,1634.2,4875,2642,279,7796,1
4402,59.4905,5.0,137.5,2734.5,6241,1164,301,7706,0
4403,27.4386,6.34,85.28,1452.0,5014,2394,204,7612,1
4404,35.34,5.0,118.0,1781.0,6072,1176,306,7554,0
4405,20.65665217,4.956521739,67.0,2234.26087,5209,1552,376,7137,0
4406,135.1055,6.5,309.0,3999.0,5996,713,258,6967,0
4407,28.379,4.6,91.6,2181.2,5533,1164,219,6916,0
4408,31.7425,4.833333333,119.6666667,2116.0,5440,1209,205,6854,0
4409,25.29875,4.5,94.0,1998.0,4369,2044,415,6828,0
4410,14.7754,4.8,51.4,1428.4,3416,3134,231,6781,0
4411,17.5296,4.6,78.4,1549.8,4587,1783,295,6665,0
4412,51.646,0.0,110.0,1995.0,4410,1639,540,6589,0
4413,14.76166667,4.666666667,75.0,1594.0,4260,2014,191,6465,0
4414,18.76848837,4.860465116,67.02325581,1391.023256,3778,2450,237,6465,1
4415,29.57028571,5.0,84.0,1997.142857,4333,1582,309,6224,1
4416,31.38814286,6.714285714,111.0,1711.571429,3376,2356,394,6126,0
4417,15.16166667,4.666666667,75.0,1594.0,4335,1502,206,6043,0
4418,6.494,5.0,30.0,903.0,2557,3145,219,5921,0
4419,53.792,6.0,134.3333333,1730.0,5074,554,256,5884,0
4420,264.675,7.0,420.0,6208.0,4186,1332,287,5805,0
4421,36.70125,4.875,91.75,2019.75,3949,1561,246,5756,0
4422,6.050333333,4.333333333,52.0,1335.0,3700,1861,157,5718,0
4423,18.19842857,5.0,87.71428571,1696.428571,3961,1422,282,5665,0
4424,50.94,6.266666667,138.2833333,1986.766667,4734,456,400,5590,1
4425,12.61125,4.5,56.25,1607.25,4209,1169,193,5571,0
4426,38.48247059,4.882352941,90.94117647,2953.588235,4491,898,166,5555,1
4427,65.56875,8.0,167.25,1998.0,4374,900,178,5452,0
4428,25.2075,5.0,80.5,1753.0,3451,1703,247,5401,0
4429,36.90769355,4.5,126.1451613,2344.0,4513,619,267,5399,0
4430,34.10357143,4.571428571,121.8571429,2555.285714,4458,699,237,5394,0
4431,35.25972727,4.727272727,104.6363636,2367.181818,4308,723,200,5231,0
4432,76.71,0.0,336.0,0.0,3929,1065,180,5174,0
4433,29.88478947,4.736842105,109.1052632,2238.631579,3201,1683,249,5133,0
4434,43.9745,4.5,98.0,2309.0,2981,1795,274,5050,0
4435,26.19775,4.625,77.0,1495.0,2417,2207,220,4844,0
4436,69.397,5.0,173.0,3358.666667,4018,586,218,4822,0
4437,38.39725,4.75,131.0,2652.375,3872,580,190,4642,0
4438,23.0525,5.0,55.0,1406.0,2461,1791,290,4542,0
4439,11.49625,4.75,50.25,1507.5,2892,1436,168,4496,0
4440,113.2693333,8.0,246.3333333,2994.666667,3161,843,175,4179,1
4441,30.92666667,4.666666667,110.3333333,2328.333333,2954,984,201,4139,0
4442,17.42714286,5.0,87.71428571,1696.428571,2744,1135,204,4083,0
4443,34.9090566,5.603773585,104.2264151,1805.924528,3468,460,138,4066,1
4444,19.45142857,3.571428571,61.0,1197.0,2029,1772,196,3997,0
4445,30.081,4.0,110.0,2254.0,2613,1098,245,3956,0
4446,55.2,6.0,163.5,2696.5,2660,1071,215,3946,0
4447,14.333375,4.5625,59.875,1183.25,1759,1981,163,3903,0
4448,23.90933333,5.0,100.6666667,2016.777778,3203,489,124,3816,0
4449,25.3433871,5.193548387,95.09677419,1802.774194,2358,1227,175,3760,0
4450,23.22409091,4.909090909,82.0,1938.0,2292,990,432,3714,0
4451,21.02333333,5.0,92.33333333,1729.333333,2302,1088,98,3488,0
4452,24.09525,6.25,68.75,1498.25,1489,1741,223,3453,0
4453,52.19640625,5.3125,126.5,2323.9375,2437,622,334,3393,0
4454,23.16515789,3.947368421,82.15789474,1817.315789,2235,1026,128,3389,0
4455,12.25,5.0,43.0,1325.0,1800,1203,124,3127,0
4456,13.818,5.0,66.0,1351.0,2381,581,133,3095,0
4457,38.79428571,4.428571429,98.57142857,2755.571429,2348,621,108,3077,1
4458,116.545,8.0,230.0,2981.0,2366,191,121,2678,0
4459,52.085,8.0,223.8333333,1969.0,2020,272,374,2666,0
4460,57.22905851,5.234042553,120.4255319,2309.340426,1856,577,175,2608,1
4461,11.9845625,4.0,69.0,1762.75,1963,413,49,2425,0
4462,23.16515789,3.947368421,82.15789474,1817.315789,1516,747,97,2360,0
4463,15.764,5.0,66.0,1497.0,1026,1185,98,2309,0
4464,134.789,8.0,390.0,4395.0,2015,122,73,2210,0
4465,11.81928571,4.619047619,56.85714286,1520.952381,1454,682,57,2193,0
4466,114.8758333,8.0,235.0,2979.0,1862,234,76,2172,0
4467,13.382,2.5,48.0,1343.0,801,1238,104,2143,0
4468,60.87,6.75,228.0,1984.0,1571,351,102,2024,0
4469,110.0985,5.0,235.0,4957.0,1717,179,91,1987,0
4470,3.781,4.0,18.0,652.0,894,994,75,1963,0
4471,21.01833333,4.666666667,66.0,1206.0,1440,442,66,1948,0
4472,11.263,4.5,55.0,1597.0,1561,309,53,1923,0
4473,108.7471951,7.853658537,207.6097561,2304.97561,1471,262,92,1825,1
4474,12.924,4.0,43.0,989.0,812,893,90,1795,0
4475,9.999666667,4.333333333,49.33333333,1347.666667,1204,502,82,1788,0
4476,22.95871429,6.285714286,80.0,998.0,1139,560,53,1752,0
4477,30.352,4.4,99.0,2117.6,1177,503,66,1746,0
4478,111.993,5.0,220.0,4988.0,1470,159,68,1697,0
4479,28.735,4.666666667,100.6666667,1590.0,1005,594,89,1688,0
4480,15.6985,4.5,73.0,1590.0,1081,520,85,1686,0
4481,13.137,5.0,93.5,1998.0,1370,240,59,1669,0
4482,31.195,6.0,105.875,1755.75,1161,419,44,1624,0
4483,29.043,5.851851852,105.0740741,1638.888889,1342,210,40,1592,0
4484,30.99,0.0,105.0,335.0,1289,258,45,1592,0
4485,646.605,6.0,450.0,5733.0,1381,146,61,1588,0
4486,17.182,5.0,74.0,1994.0,1399,136,39,1574,0
4487,55.25,6.0,177.0,1997.0,1187,311,68,1566,0
4488,158.823,4.5,250.0,3228.0,1351,130,63,1544,0
4489,34.33029412,5.588235294,105.0,1962.058824,1202,268,51,1521,1
4490,3.3322,4.6,15.6,469.6,1091,392,38,1521,0
4491,44.14181818,6.545454545,144.6363636,2242.636364,1089,390,37,1516,1
4492,12.241,5.0,57.0,1568.0,1192,275,48,1515,0
4493,19.055,4.6,89.2,1827.8,1189,247,48,1484,0
4494,71.602,4.0,149.0,3590.0,1280,150,47,1477,0
4495,93.42433333,5.0,233.0,2995.0,1345,65,42,1452,0
4496,61.235,5.0,147.0,2144.0,1229,131,45,1405,0
4497,11.34,4.0,74.0,1985.0,1073,270,58,1401,0
4498,13.31085714,4.089285714,53.33928571,1518.678571,905,399,59,1363,0
4499,28.295,5.0,96.0,1747.0,920,342,70,1332,0
4500,12.84981818,4.636363636,57.36363636,1849.545455,1014,254,36,1304,0
4501,46.5274,7.04,131.6,1596.92,1082,112,57,1251,0
4502,92.798,4.0,166.0,3980.0,1055,139,55,1249,0
4503,21.76576923,5.0,81.69230769,1808.384615,996,209,41,1246,0
4504,8.400222222,4.333333333,44.55555556,1350.0,734,466,24,1224,0
4505,5.758,4.0,43.0,1275.0,954,253,13,1220,0
4506,16.641,4.5,71.0,1590.0,386,710,48,1144,0
4507,18.6532,4.6,74.8,2652.8,909,178,34,1121,1
4508,43.89111111,5.666666667,130.5555556,2457.555556,969,89,53,1111,0
4509,71.187,5.0,239.0,4997.0,917,73,31,1021,0
4510,18.53214286,5.714285714,68.57142857,1166.142857,663317,741211,48137,1452665,0
4511,16.20874359,4.461538462,63.56410256,1650.205128,848688,435425,37824,1321937,0
4512,17.182,5.0,74.0,1994.0,412901,191178,19354,623433,0
4513,31.24215385,6.164835165,89.46153846,1537.406593,316860,205484,28578,550922,0
4514,39.97375,1.75,130.25,1998.5,434818,99993,14694,549505,0
4515,20.3776087,4.869565217,67.95652174,1279.695652,206169,313684,21661,541514,0
4516,18.2955625,4.875,70.25,1836.5,357909,84096,9863,451868,0
4517,18.1925,5.074074074,60.96296296,1408.055556,183114,231527,21896,436537,0
4518,22.1,5.615384615,75.57692308,1219.653846,154867,241354,15752,411973,0
4519,47.84837037,6.444444444,126.1111111,1995.777778,250643,93275,15566,359484,0
4520,18.64264,4.84,67.0,1698.64,191042,118199,12053,321294,0
4521,12.35588235,4.647058824,53.88235294,1366.294118,105925,173363,10568,289856,0
4522,13.11525,4.75,50.875,1430.75,131504,129130,11932,272566,0
4523,29.942625,4.5,106.225,1480.575,142794,100408,11562,254764,0
4524,26.4498867,5.408866995,87.31034483,1623.793103,137734,86611,9344,233689,0
4525,20.43008333,4.791666667,69.875,1773.0,179235,44623,7000,230858,0
4526,15.40377778,5.0,60.11111111,1593.111111,156003,57562,5293,218858,0
4527,27.23911864,3.033898305,91.61016949,1677.949153,118749,72786,8988,200523,0
4528,26.51269565,4.02173913,93.58695652,1933.021739,126677,32557,5728,164962,0
4529,10.83275,5.0,45.0,1242.0,66086,89705,6336,162127,0
4530,34.02059211,5.552631579,99.0,1920.026316,120470,30784,4797,156051,1
4531,18.84548718,4.076923077,87.07692308,2326.358974,127852,20358,3153,151363,0
4532,17.44569231,4.692307692,68.26923077,1791.230769,112511,29761,6240,148512,0
4533,12.32981818,4.818181818,53.81818182,1367.272727,65464,75640,3824,144928,0
4534,30.61932203,5.966101695,94.03389831,1497.169492,91012,43109,4165,138286,0
4535,15.46,5.0,60.8,1196.0,43096,89056,5982,138134,0
4536,93.71425,8.0,225.0,2979.0,105399,18834,5319,129552,0
4537,16.05676923,4.923076923,67.0,1703.153846,80863,42254,5382,128499,0
4538,14.350125,4.875,59.5,1642.875,81388,42528,4243,128159,0
4539,20.03375,4.833333333,71.33333333,1631.5,51225,67354,2709,121288,0
4540,39.39984314,5.784313725,117.7058824,2151.647059,91833,22536,5608,119977,0
4541,46.06451282,6.487179487,125.4358974,1835.846154,89931,21884,5673,117488,0
4542,17.34364706,4.745098039,70.92156863,1683.607843,64606,46140,4864,115610,0
4543,11.28285714,4.285714286,49.28571429,1337.714286,53229,55291,4484,113004,0
4544,16.29053333,4.8,57.86666667,1645.133333,74387,34649,3834,112870,0
4545,107.4521429,8.0,182.5714286,2425.428571,85549,22731,4331,112611,1
4546,24.84390244,4.756097561,84.92682927,1982.756098,86558,19322,3820,109700,0
4547,28.60820513,4.756410256,92.82051282,2043.820513,85510,16457,3657,105624,0
4548,20.27896296,4.111111111,72.85185185,1832.888889,68886,28904,4629,102419,0
4549,14.4382,4.9,64.2,1891.7,77037,21032,3068,101137,0
4550,22.78208333,4.916666667,81.66666667,1847.666667,51887,28076,2744,82707,0
4551,46.5274,7.04,131.6,1596.92,60863,15650,4417,80930,0
4552,27.09825,4.666666667,91.75,2247.333333,58361,14937,2722,76020,0
4553,20.7195,4.71875,81.375,1950.90625,55124,14033,2491,71648,0
4554,11.370625,5.0,48.0,1518.0,44319,22488,2436,69243,0
4555,19.93814035,5.649122807,76.31578947,1205.192982,33306,28307,2403,64016,0
4556,57.92693548,6.161290323,149.7096774,2283.112903,48047,11821,3167,63035,0
4557,37.00904545,4.590909091,114.6818182,2208.090909,43874,13983,3999,61856,0
4558,78.07322727,7.672727273,192.4,2598.818182,47588,8995,3331,59914,0
4559,14.293,4.6,75.4,1479.0,33683,23290,1830,58803,0
4560,20.35378947,4.789473684,67.68421053,1996.684211,42562,12466,2008,57036,0
4561,36.64326667,4.466666667,88.73333333,2284.133333,41428,11429,2513,55370,0
4562,137.5695455,8.0,223.5454545,2813.0,46987,5539,1996,54522,0
4563,26.803,5.428571429,85.71428571,1310.0,27628,24047,2120,53795,0
4564,23.585,5.8125,80.8125,1446.125,30796,20041,2115,52952,1
4565,17.22277778,4.888888889,70.0,1615.333333,32295,18097,1806,52198,0
4566,10.42388889,5.0,52.44444444,1095.777778,22255,26407,2091,50753,0
4567,41.616,4.6,125.36,2336.52,39092,7680,2511,49283,0
4568,22.36209302,4.88372093,72.58139535,1743.44186,31304,15218,1361,47883,0
4569,7.712,5.0,29.0,899.0,15584,28560,2029,46173,0
4570,30.236875,4.5,110.0,2316.0,32436,7963,2155,42554,0
4571,37.46857143,5.857142857,103.4285714,1718.571429,19938,19168,2727,41833,0
4572,7.92,4.0,33.33333333,868.3333333,16826,23020,1592,41438,0
4573,20.7206,3.52,74.4,1397.8,17681,19857,3285,40823,0
4574,7.863333333,5.0,44.0,1289.0,26280,13255,1183,40718,0
4575,53.78571429,6.0,124.8571429,1855.0,26916,11509,2038,40463,1
4576,59.0,7.0,166.0,1798.0,27208,9232,1942,38382,0
4577,36.38445588,4.5,125.7058824,2294.764706,29569,6580,2193,38342,0
4578,43.86363077,5.292307692,105.1692308,2083.523077,23766,12541,1838,38145,1
4579,31.5255,5.166666667,109.6666667,1861.833333,26203,10005,1632,37840,0
4580,107.6705126,8.277310924,196.3361345,2521.092437,29137,5821,1366,36324,1
4581,19.08518182,3.727272727,68.90909091,1180.545455,16027,17190,1338,34555,0
4582,43.54851613,1.35483871,137.7741935,2261.193548,16167,16235,2021,34423,0
4583,37.31523077,4.323076923,103.6769231,1873.261538,26802,5861,1354,34017,0
4584,11.389,4.142857143,53.0,1308.285714,12744,19486,1392,33622,0
4585,34.19,6.0,103.0,1794.0,21660,9593,1302,32555,0
4586,13.24516667,4.833333333,66.66666667,1506.5,18054,11821,1220,31095,0
4587,16.4455,4.666666667,78.0,1741.0,21884,8129,832,30845,0
4588,12.47666667,4.666666667,58.66666667,1498.0,18552,10721,1030,30303,0
4589,62.39565385,4.384615385,135.5,2972.307692,23348,5500,1402,30250,0
4590,22.455,6.0,92.30769231,1466.307692,17546,11470,1155,30171,0
4591,30.3775,6.3125,94.0625,935.625,13794,13614,1449,28857,0
4592,35.28132353,5.176470588,113.3529412,2106.5,21183,5926,1592,28701,0
4593,17.03876744,5.302325581,73.48837209,1374.046512,13156,13768,1122,28046,0
4594,37.32636,4.76,101.12,2349.08,22314,4589,1064,27967,0
4595,27.78966667,4.666666667,110.6666667,2050.333333,18191,7962,1230,27383,0
4596,31.30566667,6.259259259,96.92592593,1587.222222,19269,6865,1012,27146,0
4597,35.81481651,6.293577982,117.4311927,1921.46789,18063,7148,1696,26907,0
4598,20.49710714,4.142857143,72.42857143,1824.428571,18599,6281,1090,25970,0
4599,115.533,8.0,250.0,2998.0,21860,2579,1030,25469,0
4600,30.86290909,4.454545455,105.5454545,2458.909091,20993,2934,750,24677,0
4601,107.6705126,8.277310924,196.3361345,2521.092437,19616,3164,603,23383,1
4602,33.25025,6.166666667,112.75,1475.0,12138,9359,1055,22552,0
4603,31.1045119,4.547619048,93.01190476,1699.119048,11417,9808,1204,22429,0
4604,50.96109091,6.181818182,135.2909091,1971.163636,17243,3701,1480,22424,1
4605,16.67175,4.5,74.0,1541.5,14509,6887,974,22370,0
4606,36.21929825,6.473684211,94.33333333,1424.666667,12725,8031,1465,22221,0
4607,82.06090909,7.727272727,199.7272727,2790.454545,17582,2971,1177,21730,1
4608,22.69,4.8,82.2,1773.7,16007,4802,772,21581,0
4609,9.358333333,4.333333333,47.0,1324.0,9350,11103,813,21266,0
4610,30.5976,1.8,97.6,1757.6,15596,4452,1215,21263,0
4611,25.08266667,4.533333333,93.6,2127.333333,16748,3725,758,21231,0
4612,8.17,5.0,40.0,1108.0,7265,12795,803,20863,0
4613,43.08,4.666666667,105.0,2239.666667,13260,5322,1137,19719,0
4614,11.63114286,4.428571429,47.14285714,1477.0,12143,6665,635,19443,0
4615,33.70615385,6.153846154,120.1538462,1750.615385,13804,4545,647,18996,0
4616,30.0062,3.2,115.4666667,2245.6,14916,3133,798,18847,0
4617,22.35277778,4.222222222,80.92592593,1977.259259,15189,3046,514,18749,0
4618,37.52210345,3.896551724,107.3793103,2084.37931,12919,4482,1332,18733,0
4619,23.16515789,3.947368421,82.15789474,1817.315789,11862,5834,1007,18703,0
4620,10.9158,5.0,49.8,1372.4,12077,4539,455,17071,0
4621,20.1241875,4.875,79.875,1836.875,12494,3985,497,16976,0
4622,20.37,5.642857143,74.21428571,1324.357143,12719,3227,499,16445,0
4623,37.01736842,4.736842105,97.57894737,2697.368421,11643,4079,505,16227,1
4624,11.7129,4.0,69.0,1864.8,13407,2528,274,16209,0
4625,17.91985714,4.19047619,64.47619048,1759.190476,11240,3705,492,15437,0
4626,16.80266667,4.5,71.0,1764.0,11958,2914,412,15284,0
4627,49.28583333,6.0,145.0,1963.666667,10216,3563,1101,14880,0
4628,39.7374,4.6,115.0,2234.4,8209,5609,933,14751,0
4629,45.6995,6.0,114.0,1854.2,9782,3884,1008,14674,1
4630,22.95383333,5.0,67.33333333,1908.166667,9727,4214,576,14517,0
4631,36.35965,4.55,110.5,2345.1,11770,1794,526,14090,0
4632,24.84,5.0,102.0,2244.0,10408,3198,415,14021,0
4633,10.32442857,4.142857143,54.35714286,1463.857143,7989,5388,447,13824,0
4634,29.151,5.0,89.0,2526.5,9554,3512,449,13515,0
4635,39.35238095,5.0,98.04761905,1928.714286,11201,1563,435,13199,0
4636,21.407,4.5,72.0,1974.0,8950,3734,504,13188,0
4637,23.322,3.75,84.2,1853.9,10135,2525,336,12996,0
4638,17.587,4.083333333,73.08333333,1363.5,8187,4292,408,12887,0
4639,158.7922667,7.466666667,293.5333333,3005.4,10916,1125,441,12482,0
4640,17.31241935,4.967741935,66.35483871,1655.741935,8252,3518,393,12163,0
4641,30.65053846,6.346153846,95.0,1136.692308,9524,1937,468,11929,0
4642,72.79589474,6.210526316,166.3157895,3041.0,8438,2744,505,11687,0
4643,19.71783333,4.0,98.0,1995.0,7942,3003,405,11350,0
4644,35.86943902,5.585365854,117.0243902,1980.634146,9027,1669,342,11038,0
4645,11.745,5.0,51.0,998.0,4724,5403,734,10861,0
4646,61.86283333,6.833333333,184.1666667,2748.333333,5780,4082,694,10556,0
4647,9.8628,5.0,50.0,1090.4,5484,4232,393,10109,0
4648,18.16715385,4.692307692,70.30769231,1932.153846,7335,2242,427,10004,0
4649,32.898125,5.333333333,116.2916667,2081.375,7902,1498,412,9812,0
4650,13.191,5.0,51.33333333,1431.333333,3731,5596,429,9756,0
4651,66.58842105,5.736842105,172.3157895,2934.631579,8180,1064,411,9655,0
4652,22.127,5.0,83.0,1721.5,4796,4317,494,9607,0
4653,20.65665217,4.956521739,67.0,2234.26087,6986,2092,476,9554,0
4654,19.00794118,5.205882353,66.97058824,1292.352941,5663,3273,408,9344,0
4655,13.88308333,4.75,47.75,1373.75,3165,5724,452,9341,0
4656,8.4656,4.6,41.4,1182.4,5870,3116,330,9316,0
4657,23.01661538,4.730769231,90.88461538,1709.538462,6055,2777,341,9173,0
4658,52.95719388,5.653061224,146.122449,2031.469388,7579,958,616,9153,0
4659,31.79107143,4.571428571,104.1428571,2211.071429,7474,1224,360,9058,0
4660,81.295,8.0,250.0,2998.0,7194,1161,234,8589,0
4661,6.050333333,4.333333333,52.0,1335.0,5510,2858,195,8563,0
4662,25.39952941,4.647058824,78.85294118,1891.588235,6413,1771,368,8552,0
4663,12.61125,4.5,56.25,1607.25,6265,1801,264,8330,0
4664,17.5296,4.6,78.4,1549.8,5449,2278,319,8046,0
4665,59.4905,5.0,137.5,2734.5,6443,1278,301,8022,0
4666,28.379,4.6,91.6,2181.2,6275,1373,249,7897,0
4667,32.11766667,4.666666667,115.3333333,2362.0,6088,1561,235,7884,0
4668,9.5628,4.6,50.0,996.0,2963,4602,292,7857,0
4669,145.6466667,6.0,283.0,5000.0,6527,963,357,7847,0
4670,13.70454545,4.818181818,47.45454545,1384.0,3156,4368,316,7840,0
4671,77.41666667,7.0,188.3333333,2876.0,5483,1969,379,7831,1
4672,43.06842105,6.254385965,104.2017544,2222.710526,6698,659,467,7824,1
4673,40.7645,4.333333333,133.3333333,2634.222222,6218,1146,406,7770,0
4674,35.34,5.0,118.0,1781.0,6005,1272,336,7613,0
4675,28.9602,4.4,100.8,1936.6,5817,1317,294,7428,0
4676,49.82277778,6.0,115.8333333,1746.944444,4996,1693,473,7162,0
4677,6.494,5.0,30.0,903.0,2935,3853,253,7041,0
4678,23.245,4.5,98.0,1998.0,5679,1109,225,7013,0
4679,11.49625,4.75,50.25,1507.5,4418,2275,220,6913,0
4680,83.50125,6.5,213.5,3071.0,5362,1182,335,6879,0
4681,32.723,3.6,96.0,1498.0,3668,2700,265,6633,0
4682,31.7425,4.833333333,119.6666667,2116.0,5330,1096,194,6620,0
4683,14.76166667,4.666666667,75.0,1594.0,4206,1930,192,6328,0
4684,43.97,6.6,115.3,1634.2,3963,2100,232,6295,1
4685,25.29875,4.5,94.0,1998.0,3996,1837,361,6194,0
4686,35.25972727,4.727272727,104.6363636,2367.181818,4893,790,206,5889,0
4687,135.1055,6.5,309.0,3999.0,4961,604,182,5747,0
4688,25.94322222,4.777777778,67.0,1372.666667,2520,2966,246,5732,0
4689,64.59222222,6.777777778,178.5555556,2011.555556,4133,1136,298,5567,0
4690,38.48247059,4.882352941,90.94117647,2953.588235,4392,861,162,5415,1
4691,264.675,7.0,420.0,6208.0,3802,1248,234,5284,0
4692,14.7754,4.8,51.4,1428.4,2713,2384,179,5276,0
4693,29.57028571,5.0,84.0,1997.142857,3574,1313,269,5156,1
4694,39.70773684,4.842105263,117.5789474,2719.842105,3576,1323,233,5132,1
4695,38.39725,4.75,131.0,2652.375,4295,613,221,5129,0
4696,18.19842857,5.0,87.71428571,1696.428571,3572,1272,239,5083,0
4697,34.10357143,4.571428571,121.8571429,2555.285714,4211,642,221,5074,0
4698,53.792,6.0,134.3333333,1730.0,4398,464,211,5073,0
4699,69.397,5.0,173.0,3358.666667,4039,613,227,4879,0
4700,36.70125,4.875,91.75,2019.75,3290,1354,193,4837,0
4701,51.646,0.0,110.0,1995.0,3228,1169,424,4821,0
4702,43.9745,4.5,98.0,2309.0,2753,1730,252,4735,0
4703,36.90769355,4.5,126.1451613,2344.0,3710,486,232,4428,0
4704,76.71,0.0,336.0,0.0,3268,852,154,4274,0
4705,13.818,5.0,66.0,1351.0,3243,838,161,4242,0
4706,30.92666667,4.666666667,110.3333333,2328.333333,2902,973,192,4067,0
4707,17.42714286,5.0,87.71428571,1696.428571,2592,1088,189,3869,0
4708,11.9845625,4.0,69.0,1762.75,3102,656,76,3834,0
4709,23.90933333,5.0,100.6666667,2016.777778,3195,489,114,3798,0
4710,26.19775,4.625,77.0,1495.0,1930,1700,167,3797,0
4711,30.081,4.0,110.0,2254.0,2431,1044,232,3707,0
4712,11.81928571,4.619047619,56.85714286,1520.952381,2447,1128,100,3675,0
4713,55.2,6.0,163.5,2696.5,2488,969,192,3649,0
4714,18.76848837,4.860465116,67.02325581,1391.023256,2162,1337,103,3602,1
4715,50.94,6.266666667,138.2833333,1986.766667,3019,293,224,3536,1
4716,15.16166667,4.666666667,75.0,1594.0,2329,821,116,3266,0
4717,12.25,5.0,43.0,1325.0,1826,1309,121,3256,0
4718,27.4386,6.34,85.28,1452.0,2112,987,83,3182,1
4719,38.79428571,4.428571429,98.57142857,2755.571429,2359,601,108,3068,1
4720,11.263,4.5,55.0,1597.0,2373,533,86,2992,0
4721,14.333375,4.5625,59.875,1183.25,1388,1439,123,2950,0
4722,3.781,4.0,18.0,652.0,1255,1529,110,2894,0
4723,21.01833333,4.666666667,66.0,1206.0,2148,639,80,2867,0
4724,3.3322,4.6,15.6,469.6,1943,735,66,2744,0
4725,9.999666667,4.333333333,49.33333333,1347.666667,1709,785,108,2602,0
4726,34.33029412,5.588235294,105.0,1962.058824,1965,440,70,2475,1
4727,114.8758333,8.0,235.0,2979.0,2062,273,77,2412,0
4728,32.93965169,6.348314607,114.8202247,1615.370787,1622,667,113,2402,0
4729,12.84981818,4.636363636,57.36363636,1849.545455,1863,472,60,2395,0
4730,23.16515789,3.947368421,82.15789474,1817.315789,1512,770,103,2385,0
4731,15.764,5.0,66.0,1497.0,1026,1146,103,2275,0
4732,57.22905851,5.234042553,120.4255319,2309.340426,1565,501,140,2206,1
4733,25.2075,5.0,80.5,1753.0,1394,699,93,2186,0
4734,8.400222222,4.333333333,44.55555556,1350.0,1200,813,55,2068,0
4735,13.31085714,4.089285714,53.33928571,1518.678571,1320,657,79,2056,0
4736,29.043,5.851851852,105.0740741,1638.888889,1693,296,54,2043,0
4737,12.241,5.0,57.0,1568.0,1605,378,46,2029,0
4738,23.22409091,4.909090909,82.0,1938.0,1345,581,75,2001,0
4739,52.19640625,5.3125,126.5,2323.9375,1512,339,126,1977,0
4740,11.34,4.0,74.0,1985.0,1523,366,85,1974,0
4741,110.0985,5.0,235.0,4957.0,1698,181,87,1966,0
4742,134.789,8.0,390.0,4395.0,1776,111,73,1960,0
4743,116.545,8.0,230.0,2981.0,1719,136,95,1950,0
4744,13.137,5.0,93.5,1998.0,1516,287,67,1870,0
4745,15.6985,4.5,73.0,1590.0,1216,567,83,1866,0
4746,17.182,5.0,74.0,1994.0,1628,164,42,1834,0
4747,13.382,2.5,48.0,1343.0,723,1028,77,1828,0
4748,29.88478947,4.736842105,109.1052632,2238.631579,1191,562,73,1826,0
4749,12.924,4.0,43.0,989.0,838,867,91,1796,0
4750,108.7471951,7.853658537,207.6097561,2304.97561,1368,271,82,1721,1
4751,71.602,4.0,149.0,3590.0,1457,168,50,1675,0
4752,28.735,4.666666667,100.6666667,1590.0,966,601,80,1647,0
4753,111.993,5.0,220.0,4988.0,1417,153,56,1626,0
4754,5.758,4.0,43.0,1275.0,1216,348,21,1585,0
4755,12.73581818,4.636363636,54.0,1559.181818,1164,366,44,1574,0
4756,646.605,6.0,450.0,5733.0,1330,166,51,1547,0
4757,21.76576923,5.0,81.69230769,1808.384615,1201,256,47,1504,0
4758,93.42433333,5.0,233.0,2995.0,1366,76,39,1481,0
4759,61.235,5.0,147.0,2144.0,1282,140,44,1466,0
4760,18.6532,4.6,74.8,2652.8,1186,223,38,1447,1
4761,43.9745,4.5,98.0,2309.0,1091,214,44,1349,0
4762,92.798,4.0,166.0,3980.0,1073,134,55,1262,0
4763,6.895,5.0,46.0,1289.0,908,305,30,1243,0
4764,28.295,5.0,96.0,1747.0,849,317,60,1226,0
4765,50.143,5.818181818,155.5454545,2799.272727,1043,134,47,1224,0
4766,158.823,4.5,250.0,3228.0,1043,113,47,1203,0
4767,16.641,4.5,71.0,1590.0,394,703,45,1142,0
4768,9.58,4.5,61.66666667,1668.333333,758,296,35,1089,0
4769,8.118,4.0,51.5,1487.5,837,195,19,1051,0
4770,55.25,6.0,177.0,1997.0,804,198,46,1048,0
4771,60.87,6.75,228.0,1984.0,813,166,51,1030,0
4772,18.53214286,5.714285714,68.57142857,1166.142857,689216,763146,47370,1499732,0
4773,16.20874359,4.461538462,63.56410256,1650.205128,905246,465322,38200,1408768,0
4774,17.182,5.0,74.0,1994.0,440443,193015,19517,652975,0
4775,18.2955625,4.875,70.25,1836.5,445835,104583,11606,562024,0
4776,31.24215385,6.164835165,89.46153846,1537.406593,302681,196367,26380,525428,0
4777,20.3776087,4.869565217,67.95652174,1279.695652,199629,300104,19793,519526,0
4778,39.97375,1.75,130.25,1998.5,380910,86013,12731,479654,0
4779,18.1925,5.074074074,60.96296296,1408.055556,177152,219061,19927,416140,0
4780,22.1,5.615384615,75.57692308,1219.653846,134415,212654,13638,360707,0
4781,47.84837037,6.444444444,126.1111111,1995.777778,233017,87033,13931,333981,0
4782,13.11525,4.75,50.875,1430.75,142294,142491,12533,297318,0
4783,18.64264,4.84,67.0,1698.64,169731,104578,11113,285422,0
4784,12.35588235,4.647058824,53.88235294,1366.294118,98398,160927,9831,269156,0
4785,15.40377778,5.0,60.11111111,1593.111111,192361,70046,5874,268281,0
4786,20.43008333,4.791666667,69.875,1773.0,191716,46656,7227,245599,0
4787,29.942625,4.5,106.225,1480.575,131253,94384,10640,236277,0
4788,27.23911864,3.033898305,91.61016949,1677.949153,115088,69690,7963,192741,0
4789,18.84548718,4.076923077,87.07692308,2326.358974,155290,24286,3565,183141,0
4790,26.4498867,5.408866995,87.31034483,1623.793103,105805,64596,7389,177790,0
4791,10.83275,5.0,45.0,1242.0,69266,95264,6416,170946,0
4792,26.51269565,4.02173913,93.58695652,1933.021739,115704,28927,4921,149552,0
4793,17.44569231,4.692307692,68.26923077,1791.230769,113811,29779,5934,149524,0
4794,14.350125,4.875,59.5,1642.875,93637,48782,4661,147080,0
4795,11.28285714,4.285714286,49.28571429,1337.714286,63379,66784,5110,135273,0
4796,16.05676923,4.923076923,67.0,1703.153846,81329,41532,5310,128171,0
4797,34.02059211,5.552631579,99.0,1920.026316,96813,23709,3744,124266,1
4798,93.71425,8.0,225.0,2979.0,100809,18360,4780,123949,0
4799,16.29053333,4.8,57.86666667,1645.133333,79232,36012,3862,119106,0
4800,14.4382,4.9,64.2,1891.7,90413,23657,3323,117393,0
4801,17.34364706,4.745098039,70.92156863,1683.607843,64018,46066,4710,114794,0
4802,39.39984314,5.784313725,117.7058824,2151.647059,83977,21641,5092,110710,0
4803,46.06451282,6.487179487,125.4358974,1835.846154,82963,20757,5225,108945,0
4804,12.32981818,4.818181818,53.81818182,1367.272727,49654,55057,2826,107537,0
4805,20.27896296,4.111111111,72.85185185,1832.888889,71066,29263,4684,105013,0
4806,107.4521429,8.0,182.5714286,2425.428571,76860,19904,3924,100688,1
4807,24.84390244,4.756097561,84.92682927,1982.756098,79107,17331,3529,99967,0
4808,15.46,5.0,60.8,1196.0,31187,58449,4422,94058,0
4809,27.09825,4.666666667,91.75,2247.333333,62553,15788,2930,81271,0
4810,28.60820513,4.756410256,92.82051282,2043.820513,61936,11629,2671,76236,0
4811,20.7195,4.71875,81.375,1950.90625,56998,14350,2423,73771,0
4812,46.5274,7.04,131.6,1596.92,51425,13272,3729,68426,0
4813,20.35378947,4.789473684,67.68421053,1996.684211,51086,14878,2228,68192,0
4814,37.00904545,4.590909091,114.6818182,2208.090909,45407,13908,4017,63332,0
4815,22.78208333,4.916666667,81.66666667,1847.666667,39666,21438,2068,63172,0
4816,10.42388889,5.0,52.44444444,1095.777778,26216,32540,2369,61125,0
4817,19.93814035,5.649122807,76.31578947,1205.192982,31927,26951,2149,61027,0
4818,11.370625,5.0,48.0,1518.0,38920,18386,2017,59323,0
4819,30.61932203,5.966101695,94.03389831,1497.169492,38471,17200,2278,57949,0
4820,23.585,5.8125,80.8125,1446.125,34035,21431,2160,57626,1
4821,36.64326667,4.466666667,88.73333333,2284.133333,42515,11793,2620,56928,0
4822,137.5695455,8.0,223.5454545,2813.0,47709,5796,1980,55485,0
4823,20.03375,4.833333333,71.33333333,1631.5,23725,29648,1175,54548,0
4824,78.07322727,7.672727273,192.4,2598.818182,40190,7578,2747,50515,0
4825,41.616,4.6,125.36,2336.52,39734,7598,2566,49898,0
4826,14.293,4.6,75.4,1479.0,28542,19421,1489,49452,0
4827,26.803,5.428571429,85.71428571,1310.0,24920,21991,1864,48775,0
4828,57.92693548,6.161290323,149.7096774,2283.112903,35788,8475,2425,46688,0
4829,7.712,5.0,29.0,899.0,16008,28446,1974,46428,0
4830,7.863333333,5.0,44.0,1289.0,28317,13952,1201,43470,0
4831,17.22277778,4.888888889,70.0,1615.333333,26936,14625,1396,42957,0
4832,30.236875,4.5,110.0,2316.0,31935,7658,2162,41755,0
4833,7.92,4.0,33.33333333,868.3333333,15920,22847,1516,40283,0
4834,59.0,7.0,166.0,1798.0,25659,8546,1899,36104,0
4835,36.38445588,4.5,125.7058824,2294.764706,27993,5973,2100,36066,0
4836,31.5255,5.166666667,109.6666667,1861.833333,24332,9010,1350,34692,0
4837,37.46857143,5.857142857,103.4285714,1718.571429,16655,15578,2267,34500,0
4838,11.389,4.142857143,53.0,1308.285714,13559,19449,1402,34410,0
4839,107.6705126,8.277310924,196.3361345,2521.092437,26214,5295,1231,32740,1
4840,31.30566667,6.259259259,96.92592593,1587.222222,22843,8145,1108,32096,0
4841,37.32636,4.76,101.12,2349.08,25369,5099,1153,31621,0
4842,53.78571429,6.0,124.8571429,1855.0,20860,8683,1812,31355,1
4843,62.39565385,4.384615385,135.5,2972.307692,23886,5667,1442,30995,0
4844,12.47666667,4.666666667,58.66666667,1498.0,18560,10344,1030,29934,0
4845,19.08518182,3.727272727,68.90909091,1180.545455,14031,14667,1035,29733,0
4846,34.19,6.0,103.0,1794.0,19611,8962,1132,29705,0
4847,43.54851613,1.35483871,137.7741935,2261.193548,14048,13626,1625,29299,0
4848,16.4455,4.666666667,78.0,1741.0,20917,7272,729,28918,0
4849,27.78966667,4.666666667,110.6666667,2050.333333,18837,8490,1204,28531,0
4850,17.03876744,5.302325581,73.48837209,1374.046512,13049,13376,1102,27527,0
4851,11.63114286,4.428571429,47.14285714,1477.0,17061,9298,875,27234,0
4852,22.36209302,4.88372093,72.58139535,1743.44186,17665,8636,927,27228,0
4853,20.49710714,4.142857143,72.42857143,1824.428571,19129,6325,1109,26563,0
4854,107.6705126,8.277310924,196.3361345,2521.092437,21917,3666,602,26185,1
4855,115.533,8.0,250.0,2998.0,21376,2657,956,24989,0
4856,22.35277778,4.222222222,80.92592593,1977.259259,19845,4057,628,24530,0
4857,22.455,6.0,92.30769231,1466.307692,14316,8888,829,24033,0
4858,13.24516667,4.833333333,66.66666667,1506.5,13923,8641,860,23424,0
4859,43.86363077,5.292307692,105.1692308,2083.523077,14699,7399,1177,23275,1
4860,33.70615385,6.153846154,120.1538462,1750.615385,16679,5619,724,23022,0
4861,16.67175,4.5,74.0,1541.5,14908,6879,983,22770,0
4862,37.31523077,4.323076923,103.6769231,1873.261538,18184,3725,833,22742,0
4863,30.86290909,4.454545455,105.5454545,2458.909091,19195,2580,624,22399,0
4864,11.7129,4.0,69.0,1864.8,18111,3353,367,21831,0
4865,10.9158,5.0,49.8,1372.4,15403,5667,489,21559,0
4866,25.08266667,4.533333333,93.6,2127.333333,16881,3771,694,21346,0
4867,35.28132353,5.176470588,113.3529412,2106.5,15750,4316,1084,21150,0
4868,30.0062,3.2,115.4666667,2245.6,16132,3329,790,20251,0
4869,35.81481651,6.293577982,117.4311927,1921.46789,13136,5100,1106,19342,0
4870,9.358333333,4.333333333,47.0,1324.0,8458,10025,694,19177,0
4871,30.3775,6.3125,94.0625,935.625,9395,8355,987,18737,0
4872,23.16515789,3.947368421,82.15789474,1817.315789,11546,5738,1003,18287,0
4873,22.69,4.8,82.2,1773.7,13698,3814,672,18184,0
4874,43.08,4.666666667,105.0,2239.666667,12065,4730,1004,17799,0
4875,10.32442857,4.142857143,54.35714286,1463.857143,10115,6796,501,17412,0
4876,37.52210345,3.896551724,107.3793103,2084.37931,11620,4049,1244,16913,0
4877,33.25025,6.166666667,112.75,1475.0,9948,6302,637,16887,0
4878,30.5976,1.8,97.6,1757.6,11939,3641,1047,16627,0
4879,17.91985714,4.19047619,64.47619048,1759.190476,12172,3802,476,16450,0
4880,20.7206,3.52,74.4,1397.8,7011,7912,807,15730,0
4881,36.21929825,6.473684211,94.33333333,1424.666667,9067,5524,1047,15638,0
4882,36.35965,4.55,110.5,2345.1,12898,1949,572,15419,0
4883,82.06090909,7.727272727,199.7272727,2790.454545,12464,2115,834,15413,1
4884,16.80266667,4.5,71.0,1764.0,11997,2671,386,15054,0
4885,21.407,4.5,72.0,1974.0,10009,4229,530,14768,0
4886,20.37,5.642857143,74.21428571,1324.357143,11371,2874,419,14664,0
4887,50.96109091,6.181818182,135.2909091,1971.163636,10806,2286,832,13924,1
4888,37.01736842,4.736842105,97.57894737,2697.368421,9975,3361,417,13753,1
4889,24.84,5.0,102.0,2244.0,10098,3130,395,13623,0
4890,22.95383333,5.0,67.33333333,1908.166667,9012,3891,546,13449,0
4891,29.151,5.0,89.0,2526.5,9363,3380,426,13169,0
4892,6.050333333,4.333333333,52.0,1335.0,8338,4223,314,12875,0
4893,20.1241875,4.875,79.875,1836.875,9422,3059,347,12828,0
4894,8.17,5.0,40.0,1108.0,4517,7443,389,12349,0
4895,35.86943902,5.585365854,117.0243902,1980.634146,9984,1873,391,12248,0
4896,20.65665217,4.956521739,67.0,2234.26087,8911,2639,603,12153,0
4897,31.1045119,4.547619048,93.01190476,1699.119048,6390,5075,588,12053,0
4898,39.7374,4.6,115.0,2234.4,6804,4392,713,11909,0
4899,12.61125,4.5,56.25,1607.25,8707,2494,377,11578,0
4900,11.745,5.0,51.0,998.0,4888,5690,754,11332,0
4901,158.7922667,7.466666667,293.5333333,3005.4,9901,1029,398,11328,0
4902,45.6995,6.0,114.0,1854.2,7494,2983,807,11284,1
4903,17.587,4.083333333,73.08333333,1363.5,7173,3654,337,11164,0
4904,8.4656,4.6,41.4,1182.4,6523,3734,363,10620,0
4905,17.31241935,4.967741935,66.35483871,1655.741935,7174,2967,311,10452,0
4906,11.49625,4.75,50.25,1507.5,6388,3307,319,10014,0
4907,13.191,5.0,51.33333333,1431.333333,3771,5648,441,9860,0
4908,18.16715385,4.692307692,70.30769231,1932.153846,7298,2105,444,9847,0
4909,23.01661538,4.730769231,90.88461538,1709.538462,6098,2881,329,9308,0
4910,22.127,5.0,83.0,1721.5,4616,4172,480,9268,0
4911,81.295,8.0,250.0,2998.0,7526,1294,208,9028,0
4912,17.5296,4.6,78.4,1549.8,6095,2571,346,9012,0
4913,28.379,4.6,91.6,2181.2,7114,1505,263,8882,0
4914,49.28583333,6.0,145.0,1963.666667,6055,2043,649,8747,0
4915,31.79107143,4.571428571,104.1428571,2211.071429,7092,1111,304,8507,0
4916,59.4905,5.0,137.5,2734.5,6721,1360,298,8379,0
4917,19.71783333,4.0,98.0,1995.0,5597,2070,285,7952,0
4918,35.34,5.0,118.0,1781.0,6149,1339,357,7845,0
4919,6.494,5.0,30.0,903.0,3054,4360,262,7676,0
4920,40.7645,4.333333333,133.3333333,2634.222222,6029,1097,396,7522,0
4921,72.79589474,6.210526316,166.3157895,3041.0,5420,1652,315,7387,0
4922,61.86283333,6.833333333,184.1666667,2748.333333,4167,2580,461,7208,0
4923,28.9602,4.4,100.8,1936.6,5485,1212,270,6967,0
4924,9.5628,4.6,50.0,996.0,2560,3977,224,6761,0
4925,35.25972727,4.727272727,104.6363636,2367.181818,5293,834,229,6356,0
4926,145.6466667,6.0,283.0,5000.0,5279,763,292,6334,0
4927,11.81928571,4.619047619,56.85714286,1520.952381,4121,1962,166,6249,0
4928,30.65053846,6.346153846,95.0,1136.692308,4957,1006,232,6195,0
4929,31.7425,4.833333333,119.6666667,2116.0,5008,969,166,6143,0
4930,13.70454545,4.818181818,47.45454545,1384.0,2579,3295,219,6093,0
4931,11.9845625,4.0,69.0,1762.75,4794,1074,126,5994,0
4932,9.8628,5.0,50.0,1090.4,3263,2441,216,5920,0
4933,43.06842105,6.254385965,104.2017544,2222.710526,4964,493,351,5808,1
4934,14.76166667,4.666666667,75.0,1594.0,3749,1666,159,5574,0
4935,135.1055,6.5,309.0,3999.0,4788,590,175,5553,0
4936,38.39725,4.75,131.0,2652.375,4620,649,231,5500,0
4937,23.245,4.5,98.0,1998.0,4518,815,158,5491,0
4938,52.95719388,5.653061224,146.122449,2031.469388,4544,546,375,5465,0
4939,13.818,5.0,66.0,1351.0,4181,1066,176,5423,0
4940,49.82277778,6.0,115.8333333,1746.944444,3833,1209,365,5407,0
4941,38.48247059,4.882352941,90.94117647,2953.588235,4354,869,150,5373,1
4942,25.29875,4.5,94.0,1998.0,3392,1517,288,5197,0
4943,69.397,5.0,173.0,3358.666667,3984,606,221,4811,0
4944,66.58842105,5.736842105,172.3157895,2934.631579,4059,507,205,4771,0
4945,264.675,7.0,420.0,6208.0,3396,1095,204,4695,0
4946,32.898125,5.333333333,116.2916667,2081.375,3846,656,174,4676,0
4947,3.3322,4.6,15.6,469.6,3254,1314,100,4668,0
4948,34.10357143,4.571428571,121.8571429,2555.285714,3797,571,196,4564,0
4949,43.97,6.6,115.3,1634.2,2732,1410,139,4281,1
4950,11.263,4.5,55.0,1597.0,3397,771,99,4267,0
4951,18.19842857,5.0,87.71428571,1696.428571,2996,1052,193,4241,0
4952,32.11766667,4.666666667,115.3333333,2362.0,3127,769,271,4167,0
4953,43.9745,4.5,98.0,2309.0,2397,1566,200,4163,0
4954,29.57028571,5.0,84.0,1997.142857,2916,1012,224,4152,1
4955,12.84981818,4.636363636,57.36363636,1849.545455,3169,834,92,4095,0
4956,36.70125,4.875,91.75,2019.75,2677,1242,160,4079,0
4957,53.792,6.0,134.3333333,1730.0,3496,341,169,4006,0
4958,83.50125,6.5,213.5,3071.0,3051,711,187,3949,0
4959,30.92666667,4.666666667,110.3333333,2328.333333,2829,926,183,3938,0
4960,3.781,4.0,18.0,652.0,1650,2144,127,3921,0
4961,13.88308333,4.75,47.75,1373.75,1372,2318,208,3898,0
4962,21.01833333,4.666666667,66.0,1206.0,2958,836,97,3891,0
4963,23.90933333,5.0,100.6666667,2016.777778,3099,487,109,3695,0
4964,34.33029412,5.588235294,105.0,1962.058824,2898,675,96,3669,1
4965,9.999666667,4.333333333,49.33333333,1347.666667,2366,1108,128,3602,0
4966,76.71,0.0,336.0,0.0,2713,690,137,3540,0
4967,8.400222222,4.333333333,44.55555556,1350.0,2054,1292,93,3439,0
4968,36.90769355,4.5,126.1451613,2344.0,2875,364,190,3429,0
4969,17.42714286,5.0,87.71428571,1696.428571,2256,937,171,3364,0
4970,55.2,6.0,163.5,2696.5,2321,846,174,3341,0
4971,51.646,0.0,110.0,1995.0,2237,777,291,3305,0
4972,30.081,4.0,110.0,2254.0,2133,936,194,3263,0
4973,39.70773684,4.842105263,117.5789474,2719.842105,2290,779,147,3216,1
4974,12.25,5.0,43.0,1325.0,1801,1286,107,3194,0
4975,77.41666667,7.0,188.3333333,2876.0,2160,775,162,3097,1
4976,13.31085714,4.089285714,53.33928571,1518.678571,1983,963,102,3048,0
4977,38.79428571,4.428571429,98.57142857,2755.571429,2273,583,100,2956,1
4978,26.19775,4.625,77.0,1495.0,1475,1282,119,2876,0
4979,32.723,3.6,96.0,1498.0,1622,1138,103,2863,0
4980,12.73581818,4.636363636,54.0,1559.181818,2077,638,84,2799,0
4981,114.8758333,8.0,235.0,2979.0,2379,333,75,2787,0
4982,11.34,4.0,74.0,1985.0,2046,517,124,2687,0
4983,29.043,5.851851852,105.0740741,1638.888889,2116,421,69,2606,0
4984,12.241,5.0,57.0,1568.0,2009,516,75,2600,0
4985,39.35238095,5.0,98.04761905,1928.714286,2189,233,96,2518,0
4986,25.94322222,4.777777778,67.0,1372.666667,1117,1143,91,2351,0
4987,23.16515789,3.947368421,82.15789474,1817.315789,1498,729,103,2330,0
4988,17.182,5.0,74.0,1994.0,1978,235,44,2257,0
4989,5.758,4.0,43.0,1275.0,1702,488,28,2218,0
4990,6.895,5.0,46.0,1289.0,1553,574,53,2180,0
4991,14.7754,4.8,51.4,1428.4,1084,1008,82,2174,0
4992,15.764,5.0,66.0,1497.0,964,1118,92,2174,0
4993,13.137,5.0,93.5,1998.0,1725,332,77,2134,0
4994,110.0985,5.0,235.0,4957.0,1818,207,93,2118,0
4995,25.39952941,4.647058824,78.85294118,1891.588235,1576,433,109,2118,0
4996,15.6985,4.5,73.0,1590.0,1299,590,74,1963,0
4997,43.9745,4.5,98.0,2309.0,1565,312,63,1940,0
4998,14.333375,4.5625,59.875,1183.25,907,930,79,1916,0
4999,9.58,4.5,61.66666667,1668.333333,1362,504,49,1915,0
5000,71.602,4.0,149.0,3590.0,1641,206,57,1904,0
5001,18.6532,4.6,74.8,2652.8,1503,270,45,1818,1
5002,12.924,4.0,43.0,989.0,858,864,87,1809,0
5003,57.22905851,5.234042553,120.4255319,2309.340426,1263,380,111,1754,1
5004,134.789,8.0,390.0,4395.0,1536,110,52,1698,0
5005,21.76576923,5.0,81.69230769,1808.384615,1339,285,51,1675,0
5006,108.7471951,7.853658537,207.6097561,2304.97561,1296,250,90,1636,1
5007,8.118,4.0,51.5,1487.5,1276,312,30,1618,0
5008,61.235,5.0,147.0,2144.0,1400,157,44,1601,0
5009,646.605,6.0,450.0,5733.0,1361,171,52,1584,0
5010,111.993,5.0,220.0,4988.0,1340,141,55,1536,0
5011,93.42433333,5.0,233.0,2995.0,1423,81,30,1534,0
5012,14.275,5.0,70.0,1997.0,1003,462,47,1512,1
5013,50.143,5.818181818,155.5454545,2799.272727,1273,181,58,1512,0
5014,28.735,4.666666667,100.6666667,1590.0,884,525,69,1478,0
5015,50.94,6.266666667,138.2833333,1986.766667,1236,128,84,1448,1
5016,116.545,8.0,230.0,2981.0,1237,108,60,1405,0
5017,64.59222222,6.777777778,178.5555556,2011.555556,989,215,69,1273,0
5018,92.798,4.0,166.0,3980.0,1069,115,51,1235,0
5019,14.93453333,4.333333333,59.6,1655.066667,941,213,44,1198,0
5020,16.641,4.5,71.0,1590.0,394,712,41,1147,0
5021,27.4386,6.34,85.28,1452.0,696,382,40,1118,1
5022,106.82,4.0,234.0,5993.0,925,99,65,1089,0
5023,4.626333333,4.0,34.0,1046.0,718,327,26,1071,0
5024,10.54685714,5.0,49.42857143,1418.428571,733,297,24,1054,0
5025,28.295,5.0,96.0,1747.0,713,264,52,1029,0
5026,15.16166667,4.666666667,75.0,1594.0,730,249,28,1007,0
5027,6.587333333,4.0,22.33333333,932.6666667,538,396,72,1006,0
5028,15.11811765,4.588235294,61.76470588,1603.117647,795,185,24,1004,0
5029,18.53214286,5.714285714,68.57142857,1166.142857,710871,781033,44195,1536099,0
5030,16.20874359,4.461538462,63.56410256,1650.205128,949263,490659,37823,1477745,0
5031,18.2955625,4.875,70.25,1836.5,536947,123812,12660,673419,0
5032,17.182,5.0,74.0,1994.0,445497,178664,18587,642748,0
5033,31.24215385,6.164835165,89.46153846,1537.406593,285563,186914,24006,496483,0
5034,20.3776087,4.869565217,67.95652174,1279.695652,189417,278748,17877,486042,0
5035,18.1925,5.074074074,60.96296296,1408.055556,171011,207164,17770,395945,0
5036,39.97375,1.75,130.25,1998.5,313299,68280,10400,391979,0
5037,13.11525,4.75,50.875,1430.75,149939,154594,12796,317329,0
5038,15.40377778,5.0,60.11111111,1593.111111,228614,81548,5954,316116,0
5039,22.1,5.615384615,75.57692308,1219.653846,114394,179402,11469,305265,0
5040,47.84837037,6.444444444,126.1111111,1995.777778,213172,78887,12269,304328,0
5041,20.43008333,4.791666667,69.875,1773.0,196371,46107,7091,249569,0
5042,12.35588235,4.647058824,53.88235294,1366.294118,91014,146039,9199,246252,0
5043,18.64264,4.84,67.0,1698.64,139364,83474,9606,232444,0
5044,29.942625,4.5,106.225,1480.575,114996,85457,9493,209946,0
5045,18.84548718,4.076923077,87.07692308,2326.358974,178198,27173,3667,209038,0
5046,27.23911864,3.033898305,91.61016949,1677.949153,109831,65322,7084,182237,0
5047,10.83275,5.0,45.0,1242.0,71404,98396,6232,176032,0
5048,14.350125,4.875,59.5,1642.875,103721,53076,4863,161660,0
5049,11.28285714,4.285714286,49.28571429,1337.714286,72206,78466,5378,156050,0
5050,17.44569231,4.692307692,68.26923077,1791.230769,113408,28896,5582,147886,0
5051,14.4382,4.9,64.2,1891.7,101692,25423,3305,130420,0
5052,26.51269565,4.02173913,93.58695652,1933.021739,100859,24210,4126,129195,0
5053,16.05676923,4.923076923,67.0,1703.153846,81229,39740,5328,126297,0
5054,16.29053333,4.8,57.86666667,1645.133333,81833,35833,3715,121381,0
5055,26.4498867,5.408866995,87.31034483,1623.793103,72363,42182,5170,119715,0
5056,93.71425,8.0,225.0,2979.0,94995,17548,4440,116983,0
5057,17.34364706,4.745098039,70.92156863,1683.607843,62146,44234,4305,110685,0
5058,20.27896296,4.111111111,72.85185185,1832.888889,71332,28941,4707,104980,0
5059,39.39984314,5.784313725,117.7058824,2151.647059,78250,21106,4726,104082,0
5060,46.06451282,6.487179487,125.4358974,1835.846154,77942,19807,4720,102469,0
5061,34.02059211,5.552631579,99.0,1920.026316,71948,16606,2742,91296,1
5062,107.4521429,8.0,182.5714286,2425.428571,65983,16559,3429,85971,1
5063,27.09825,4.666666667,91.75,2247.333333,65631,16186,2988,84805,0
5064,24.84390244,4.756097561,84.92682927,1982.756098,67250,13689,3072,84011,0
5065,20.35378947,4.789473684,67.68421053,1996.684211,57420,16450,2410,76280,0
5066,20.7195,4.71875,81.375,1950.90625,56745,13744,2248,72737,0
5067,10.42388889,5.0,52.44444444,1095.777778,28837,38143,2485,69465,0
5068,12.32981818,4.818181818,53.81818182,1367.272727,31647,34011,1934,67592,0
5069,37.00904545,4.590909091,114.6818182,2208.090909,45608,13325,3875,62808,0
5070,23.585,5.8125,80.8125,1446.125,36651,21646,2081,60378,1
5071,36.64326667,4.466666667,88.73333333,2284.133333,42572,11997,2603,57172,0
5072,19.93814035,5.649122807,76.31578947,1205.192982,30348,24931,1803,57082,0
5073,137.5695455,8.0,223.5454545,2813.0,46414,5793,1909,54116,0
5074,46.5274,7.04,131.6,1596.92,40261,10320,2894,53475,0
5075,15.46,5.0,60.8,1196.0,19140,31422,2630,53192,0
5076,41.616,4.6,125.36,2336.52,38540,6918,2541,47999,0
5077,28.60820513,4.756410256,92.82051282,2043.820513,38848,7009,1758,47615,0
5078,11.370625,5.0,48.0,1518.0,31791,13930,1531,47252,0
5079,22.78208333,4.916666667,81.66666667,1847.666667,29121,15367,1504,45992,0
5080,7.863333333,5.0,44.0,1289.0,30176,13989,1152,45317,0
5081,7.712,5.0,29.0,899.0,16296,27137,1828,45261,0
5082,26.803,5.428571429,85.71428571,1310.0,22457,19489,1635,43581,0
5083,30.236875,4.5,110.0,2316.0,30529,7007,2121,39657,0
5084,78.07322727,7.672727273,192.4,2598.818182,31386,5904,2135,39425,0
5085,7.92,4.0,33.33333333,868.3333333,14989,22846,1423,39258,0
5086,14.293,4.6,75.4,1479.0,22426,14225,1099,37750,0
5087,31.30566667,6.259259259,96.92592593,1587.222222,26114,9345,1197,36656,0
5088,11.63114286,4.428571429,47.14285714,1477.0,22471,12581,1044,36096,0
5089,37.32636,4.76,101.12,2349.08,27781,5415,1212,34408,0
5090,31.5255,5.166666667,109.6666667,1861.833333,22886,8270,1190,32346,0
5091,59.0,7.0,166.0,1798.0,23118,7470,1651,32239,0
5092,17.22277778,4.888888889,70.0,1615.333333,20597,10550,1076,32223,0
5093,36.38445588,4.5,125.7058824,2294.764706,24932,4973,1959,31864,0
5094,11.389,4.142857143,53.0,1308.285714,12788,17390,1239,31417,0
5095,57.92693548,6.161290323,149.7096774,2283.112903,23564,5352,1721,30637,0
5096,62.39565385,4.384615385,135.5,2972.307692,23678,5519,1400,30597,0
5097,22.35277778,4.222222222,80.92592593,1977.259259,24277,4853,751,29881,0
5098,11.7129,4.0,69.0,1864.8,23969,4466,449,28884,0
5099,107.6705126,8.277310924,196.3361345,2521.092437,22994,4684,1117,28795,1
5100,12.47666667,4.666666667,58.66666667,1498.0,18081,9525,1031,28637,0
5101,27.78966667,4.666666667,110.6666667,2050.333333,18656,8742,1165,28563,0
5102,107.6705126,8.277310924,196.3361345,2521.092437,23639,4045,628,28312,1
5103,34.19,6.0,103.0,1794.0,18195,8804,1025,28024,0
5104,33.70615385,6.153846154,120.1538462,1750.615385,19263,6730,844,26837,0
5105,16.4455,4.666666667,78.0,1741.0,19341,6168,628,26137,0
5106,20.49710714,4.142857143,72.42857143,1824.428571,18879,6152,1090,26121,0
5107,37.46857143,5.857142857,103.4285714,1718.571429,12752,11374,1697,25823,0
5108,19.08518182,3.727272727,68.90909091,1180.545455,12208,12567,832,25607,0
5109,10.9158,5.0,49.8,1372.4,18446,6311,511,25268,0
5110,17.03876744,5.302325581,73.48837209,1374.046512,11735,12013,925,24673,0
5111,43.54851613,1.35483871,137.7741935,2261.193548,12143,10994,1322,24459,0
5112,115.533,8.0,250.0,2998.0,20238,2533,881,23652,0
5113,16.67175,4.5,74.0,1541.5,15267,6721,992,22980,0
5114,30.0062,3.2,115.4666667,2245.6,17090,3470,793,21353,0
5115,25.08266667,4.533333333,93.6,2127.333333,16509,3663,633,20805,0
5116,53.78571429,6.0,124.8571429,1855.0,13885,5515,1276,20676,1
5117,10.32442857,4.142857143,54.35714286,1463.857143,12012,8019,555,20586,0
5118,6.050333333,4.333333333,52.0,1335.0,12596,6312,411,19319,0
5119,30.86290909,4.454545455,105.5454545,2458.909091,15917,2031,513,18461,0
5120,33.25025,6.166666667,112.75,1475.0,10223,6822,538,17583,0
5121,9.358333333,4.333333333,47.0,1324.0,7946,8940,578,17464,0
5122,23.16515789,3.947368421,82.15789474,1817.315789,10639,5216,964,16819,0
5123,17.91985714,4.19047619,64.47619048,1759.190476,12630,3694,435,16759,0
5124,22.455,6.0,92.30769231,1466.307692,9933,5636,558,16127,0
5125,36.35965,4.55,110.5,2345.1,13461,2031,585,16077,0
5126,21.407,4.5,72.0,1974.0,11029,4508,526,16063,0
5127,43.08,4.666666667,105.0,2239.666667,10835,4049,894,15778,0
5128,12.61125,4.5,56.25,1607.25,11371,3458,462,15291,0
5129,37.52210345,3.896551724,107.3793103,2084.37931,9897,3499,1143,14539,0
5130,20.65665217,4.956521739,67.0,2234.26087,10642,3110,728,14480,0
5131,16.80266667,4.5,71.0,1764.0,11332,2416,363,14111,0
5132,11.49625,4.75,50.25,1507.5,8889,4607,373,13869,0
5133,35.28132353,5.176470588,113.3529412,2106.5,9733,2545,678,12956,0
5134,35.86943902,5.585365854,117.0243902,1980.634146,10455,2032,418,12905,0
5135,20.37,5.642857143,74.21428571,1324.357143,9894,2458,324,12676,0
5136,24.84,5.0,102.0,2244.0,9313,2933,384,12630,0
5137,29.151,5.0,89.0,2526.5,8845,3050,378,12273,0
5138,22.69,4.8,82.2,1773.7,9299,2513,430,12242,0
5139,30.5976,1.8,97.6,1757.6,8339,2835,841,12015,0
5140,22.95383333,5.0,67.33333333,1908.166667,7783,3433,494,11710,0
5141,35.81481651,6.293577982,117.4311927,1921.46789,7968,3027,692,11687,0
5142,11.745,5.0,51.0,998.0,4961,5864,779,11604,0
5143,43.86363077,5.292307692,105.1692308,2083.523077,7312,3584,612,11508,1
5144,22.36209302,4.88372093,72.58139535,1743.44186,7498,3583,413,11494,0
5145,13.24516667,4.833333333,66.66666667,1506.5,6953,4097,426,11476,0
5146,8.4656,4.6,41.4,1182.4,6702,4330,361,11393,0
5147,37.01736842,4.736842105,97.57894737,2697.368421,7993,2498,357,10848,1
5148,11.81928571,4.619047619,56.85714286,1520.952381,6972,3268,226,10466,0
5149,37.31523077,4.323076923,103.6769231,1873.261538,8412,1622,377,10411,0
5150,36.21929825,6.473684211,94.33333333,1424.666667,5863,3392,625,9880,0
5151,23.01661538,4.730769231,90.88461538,1709.538462,6450,3017,329,9796,0
5152,158.7922667,7.466666667,293.5333333,3005.4,8435,905,357,9697,0
5153,28.379,4.6,91.6,2181.2,7733,1628,290,9651,0
5154,18.16715385,4.692307692,70.30769231,1932.153846,7165,1937,477,9579,0
5155,82.06090909,7.727272727,199.7272727,2790.454545,7881,1177,511,9569,1
5156,17.5296,4.6,78.4,1549.8,6395,2768,352,9515,0
5157,13.191,5.0,51.33333333,1431.333333,3598,5414,401,9413,0
5158,81.295,8.0,250.0,2998.0,7459,1306,227,8992,0
5159,30.3775,6.3125,94.0625,935.625,4708,3818,455,8981,0
5160,22.127,5.0,83.0,1721.5,4378,3995,462,8835,0
5161,11.9845625,4.0,69.0,1762.75,6969,1591,163,8723,0
5162,17.587,4.083333333,73.08333333,1363.5,5623,2780,240,8643,0
5163,59.4905,5.0,137.5,2734.5,6857,1418,318,8593,0
5164,45.6995,6.0,114.0,1854.2,5576,2154,607,8337,1
5165,17.31241935,4.967741935,66.35483871,1655.741935,5723,2279,223,8225,0
5166,6.494,5.0,30.0,903.0,3029,4801,251,8081,0
5167,20.03375,4.833333333,71.33333333,1631.5,3937,3904,136,7977,0
5168,3.3322,4.6,15.6,469.6,5360,2367,159,7886,0
5169,35.34,5.0,118.0,1781.0,6062,1366,375,7803,0
5170,39.7374,4.6,115.0,2234.4,4447,2680,441,7568,0
5171,31.79107143,4.571428571,104.1428571,2211.071429,6209,881,271,7361,0
5172,50.96109091,6.181818182,135.2909091,1971.163636,5614,1162,440,7216,1
5173,40.7645,4.333333333,133.3333333,2634.222222,5574,956,357,6887,0
5174,12.84981818,4.636363636,57.36363636,1849.545455,5271,1412,145,6828,0
5175,13.818,5.0,66.0,1351.0,4995,1349,212,6556,0
5176,35.25972727,4.727272727,104.6363636,2367.181818,5311,840,246,6397,0
5177,19.71783333,4.0,98.0,1995.0,4359,1454,222,6035,0
5178,8.400222222,4.333333333,44.55555556,1350.0,3471,2313,143,5927,0
5179,11.263,4.5,55.0,1597.0,4508,1008,114,5630,0
5180,38.39725,4.75,131.0,2652.375,4749,627,226,5602,0
5181,20.1241875,4.875,79.875,1836.875,4260,1186,148,5594,0
5182,28.9602,4.4,100.8,1936.6,4399,920,247,5566,0
5183,31.7425,4.833333333,119.6666667,2116.0,4300,793,134,5227,0
5184,14.76166667,4.666666667,75.0,1594.0,3621,1426,156,5203,0
5185,9.5628,4.6,50.0,996.0,1924,3086,176,5186,0
5186,38.48247059,4.882352941,90.94117647,2953.588235,4172,869,139,5180,1
5187,9.999666667,4.333333333,49.33333333,1347.666667,3192,1606,167,4965,0
5188,3.781,4.0,18.0,652.0,1978,2796,148,4922,0
5189,21.01833333,4.666666667,66.0,1206.0,3732,1079,110,4921,0
5190,34.33029412,5.588235294,105.0,1962.058824,3917,882,102,4901,1
5191,12.73581818,4.636363636,54.0,1559.181818,3579,1162,135,4876,0
5192,145.6466667,6.0,283.0,5000.0,4037,578,219,4834,0
5193,135.1055,6.5,309.0,3999.0,4074,498,134,4706,0
5194,69.397,5.0,173.0,3358.666667,3845,551,203,4599,0
5195,13.31085714,4.089285714,53.33928571,1518.678571,2911,1482,115,4508,0
5196,61.86283333,6.833333333,184.1666667,2748.333333,2574,1409,267,4250,0
5197,13.70454545,4.818181818,47.45454545,1384.0,1849,2058,149,4056,0
5198,264.675,7.0,420.0,6208.0,2800,898,146,3844,0
5199,34.10357143,4.571428571,121.8571429,2555.285714,3170,485,177,3832,0
5200,43.06842105,6.254385965,104.2017544,2222.710526,3231,337,237,3805,1
5201,30.92666667,4.666666667,110.3333333,2328.333333,2682,901,170,3753,0
5202,8.17,5.0,40.0,1108.0,1507,2098,101,3706,0
5203,49.82277778,6.0,115.8333333,1746.944444,2596,806,252,3654,0
5204,6.895,5.0,46.0,1289.0,2543,1015,71,3629,0
5205,25.29875,4.5,94.0,1998.0,2416,1008,199,3623,0
5206,11.34,4.0,74.0,1985.0,2698,704,144,3546,0
5207,49.28583333,6.0,145.0,1963.666667,2437,787,236,3460,0
5208,43.9745,4.5,98.0,2309.0,1994,1264,151,3409,0
5209,23.90933333,5.0,100.6666667,2016.777778,2827,433,112,3372,0
5210,9.58,4.5,61.66666667,1668.333333,2395,869,84,3348,0
5211,12.25,5.0,43.0,1325.0,1781,1398,116,3295,0
5212,29.57028571,5.0,84.0,1997.142857,2256,790,193,3239,1
5213,29.043,5.851851852,105.0740741,1638.888889,2567,590,77,3234,0
5214,23.245,4.5,98.0,1998.0,2648,447,90,3185,0
5215,9.8628,5.0,50.0,1090.4,1809,1256,98,3163,0
5216,5.758,4.0,43.0,1275.0,2378,738,41,3157,0
5217,12.241,5.0,57.0,1568.0,2374,636,86,3096,0
5218,114.8758333,8.0,235.0,2979.0,2630,364,100,3094,0
5219,18.19842857,5.0,87.71428571,1696.428571,2153,777,141,3071,0
5220,43.97,6.6,115.3,1634.2,2005,944,92,3041,1
5221,36.70125,4.875,91.75,2019.75,1879,969,130,2978,0
5222,72.79589474,6.210526316,166.3157895,3041.0,2159,596,122,2877,0
5223,17.182,5.0,74.0,1994.0,2475,279,53,2807,0
5224,55.2,6.0,163.5,2696.5,1908,655,163,2726,0
5225,17.42714286,5.0,87.71428571,1696.428571,1810,749,148,2707,0
5226,38.79428571,4.428571429,98.57142857,2755.571429,2057,530,101,2688,1
5227,8.118,4.0,51.5,1487.5,2102,539,45,2686,0
5228,30.081,4.0,110.0,2254.0,1740,767,148,2655,0
5229,43.9745,4.5,98.0,2309.0,2145,434,67,2646,0
5230,14.275,5.0,70.0,1997.0,1603,825,59,2487,1
5231,76.71,0.0,336.0,0.0,1876,420,115,2411,0
5232,53.792,6.0,134.3333333,1730.0,2084,191,107,2382,0
5233,52.95719388,5.653061224,146.122449,2031.469388,2041,173,151,2365,0
5234,13.137,5.0,93.5,1998.0,1815,371,80,2266,0
5235,83.50125,6.5,213.5,3071.0,1761,358,102,2221,0
5236,18.6532,4.6,74.8,2652.8,1837,327,48,2212,1
5237,23.16515789,3.947368421,82.15789474,1817.315789,1444,662,100,2206,0
5238,110.0985,5.0,235.0,4957.0,1846,230,88,2164,0
5239,15.764,5.0,66.0,1497.0,971,1069,91,2131,0
5240,32.898125,5.333333333,116.2916667,2081.375,1770,286,64,2120,0
5241,31.1045119,4.547619048,93.01190476,1699.119048,1129,844,83,2056,0
5242,36.90769355,4.5,126.1451613,2344.0,1697,221,113,2031,0
5243,15.6985,4.5,73.0,1590.0,1357,593,65,2015,0
5244,71.602,4.0,149.0,3590.0,1698,228,64,1990,0
5245,30.61932203,5.966101695,94.03389831,1497.169492,1291,584,76,1951,0
5246,21.76576923,5.0,81.69230769,1808.384615,1450,310,67,1827,0
5247,30.65053846,6.346153846,95.0,1136.692308,1444,275,62,1781,0
5248,50.143,5.818181818,155.5454545,2799.272727,1489,227,57,1773,0
5249,51.646,0.0,110.0,1995.0,1229,382,154,1765,0
5250,14.93453333,4.333333333,59.6,1655.066667,1398,316,47,1761,0
5251,4.626333333,4.0,34.0,1046.0,1140,571,34,1745,0
5252,61.235,5.0,147.0,2144.0,1511,168,44,1723,0
5253,134.789,8.0,390.0,4395.0,1444,131,48,1623,0
5254,12.924,4.0,43.0,989.0,763,738,62,1563,0
5255,15.11811765,4.588235294,61.76470588,1603.117647,1197,299,34,1530,0
5256,108.7471951,7.853658537,207.6097561,2304.97561,1219,208,82,1509,1
5257,646.605,6.0,450.0,5733.0,1277,155,53,1485,0
5258,93.42433333,5.0,233.0,2995.0,1348,82,36,1466,0
5259,10.54685714,5.0,49.42857143,1418.428571,964,436,29,1429,0
5260,26.19775,4.625,77.0,1495.0,747,606,54,1407,0
5261,6.587333333,4.0,22.33333333,932.6666667,655,536,89,1280,0
5262,111.993,5.0,220.0,4988.0,1090,121,37,1248,0
5263,92.798,4.0,166.0,3980.0,1048,105,51,1204,0
5264,39.70773684,4.842105263,117.5789474,2719.842105,852,283,45,1180,1
5265,106.82,4.0,234.0,5993.0,968,112,64,1144,0
5266,28.735,4.666666667,100.6666667,1590.0,688,388,52,1128,0
5267,16.641,4.5,71.0,1590.0,417,642,40,1099,0
5268,32.99,5.0,132.0,2969.0,955,120,17,1092,0
5269,57.22905851,5.234042553,120.4255319,2309.340426,765,234,60,1059,1
5270,13.2218,4.6,70.2,1736.2,761,238,29,1028,0
5271,18.53214286,5.714285714,68.57142857,1166.142857,730276,789633,41603,1561512,0
5272,16.20874359,4.461538462,63.56410256,1650.205128,972994,499757,36804,1509555,0
5273,18.2955625,4.875,70.25,1836.5,627023,140590,13752,781365,0
5274,17.182,5.0,74.0,1994.0,438632,160382,16906,615920,0
5275,31.24215385,6.164835165,89.46153846,1537.406593,276591,180976,22701,480268,0
5276,20.3776087,4.869565217,67.95652174,1279.695652,179905,256814,16147,452866,0
5277,18.1925,5.074074074,60.96296296,1408.055556,164289,193359,15933,373581,0
5278,15.40377778,5.0,60.11111111,1593.111111,263928,90739,6123,360790,0
5279,13.11525,4.75,50.875,1430.75,156413,162705,13083,332201,0
5280,39.97375,1.75,130.25,1998.5,233123,48504,7595,289222,0
5281,47.84837037,6.444444444,126.1111111,1995.777778,200017,72713,11061,283791,0
5282,22.1,5.615384615,75.57692308,1219.653846,97432,146456,9880,253768,0
5283,20.43008333,4.791666667,69.875,1773.0,194048,43157,6881,244086,0
5284,18.84548718,4.076923077,87.07692308,2326.358974,197427,29298,3792,230517,0
5285,12.35588235,4.647058824,53.88235294,1366.294118,74580,118211,7834,200625,0
5286,29.942625,4.5,106.225,1480.575,97756,75982,8278,182016,0
5287,10.83275,5.0,45.0,1242.0,73315,99333,6116,178764,0
5288,11.28285714,4.285714286,49.28571429,1337.714286,82598,89362,5691,177651,0
5289,18.64264,4.84,67.0,1698.64,106029,61403,7959,175391,0
5290,14.350125,4.875,59.5,1642.875,111850,55437,4872,172159,0
5291,27.23911864,3.033898305,91.61016949,1677.949153,104288,60228,6336,170852,0
5292,17.44569231,4.692307692,68.26923077,1791.230769,109426,26789,5137,141352,0
5293,14.4382,4.9,64.2,1891.7,110151,25996,3315,139462,0
5294,16.29053333,4.8,57.86666667,1645.133333,83479,34913,3690,122082,0
5295,16.05676923,4.923076923,67.0,1703.153846,77971,36408,5180,119559,0
5296,93.71425,8.0,225.0,2979.0,87412,16444,3916,107772,0
5297,26.51269565,4.02173913,93.58695652,1933.021739,83876,19416,3397,106689,0
5298,17.34364706,4.745098039,70.92156863,1683.607843,60199,41742,3911,105852,0
5299,20.27896296,4.111111111,72.85185185,1832.888889,70997,28115,4728,103840,0
5300,39.39984314,5.784313725,117.7058824,2151.647059,75612,20950,4491,101053,0
5301,46.06451282,6.487179487,125.4358974,1835.846154,72507,18564,4199,95270,0
5302,27.09825,4.666666667,91.75,2247.333333,67529,16239,3091,86859,0
5303,20.35378947,4.789473684,67.68421053,1996.684211,62991,17149,2548,82688,0
5304,10.42388889,5.0,52.44444444,1095.777778,31844,44198,2636,78678,0
5305,107.4521429,8.0,182.5714286,2425.428571,57328,13822,3119,74269,1
5306,20.7195,4.71875,81.375,1950.90625,56182,13204,2116,71502,0
5307,24.84390244,4.756097561,84.92682927,1982.756098,51423,9687,2530,63640,0
5308,34.02059211,5.552631579,99.0,1920.026316,50451,10869,2021,63341,1
5309,23.585,5.8125,80.8125,1446.125,38870,20998,1981,61849,1
5310,37.00904545,4.590909091,114.6818182,2208.090909,44386,12358,3751,60495,0
5311,26.4498867,5.408866995,87.31034483,1623.793103,37014,20774,2625,60413,0
5312,36.64326667,4.466666667,88.73333333,2284.133333,42414,12140,2610,57164,0
5313,19.93814035,5.649122807,76.31578947,1205.192982,29681,24275,1675,55631,0
5314,137.5695455,8.0,223.5454545,2813.0,44039,5719,1739,51497,0
5315,7.863333333,5.0,44.0,1289.0,31598,13603,1107,46308,0
5316,11.63114286,4.428571429,47.14285714,1477.0,28253,15591,1230,45074,0
5317,41.616,4.6,125.36,2336.52,36024,6153,2444,44621,0
5318,31.30566667,6.259259259,96.92592593,1587.222222,29386,10272,1286,40944,0
5319,7.712,5.0,29.0,899.0,14483,22957,1540,38980,0
5320,46.5274,7.04,131.6,1596.92,28939,7273,2069,38281,0
5321,26.803,5.428571429,85.71428571,1310.0,19943,16715,1408,38066,0
5322,11.7129,4.0,69.0,1864.8,31429,5994,531,37954,0
5323,7.92,4.0,33.33333333,868.3333333,13745,22631,1329,37705,0
5324,37.32636,4.76,101.12,2349.08,29758,5716,1285,36759,0
5325,30.236875,4.5,110.0,2316.0,27963,6071,2009,36043,0
5326,12.32981818,4.818181818,53.81818182,1367.272727,16615,17727,1124,35466,0
5327,22.35277778,4.222222222,80.92592593,1977.259259,28298,5581,826,34705,0
5328,11.370625,5.0,48.0,1518.0,21488,8817,954,31259,0
5329,10.9158,5.0,49.8,1372.4,22723,7314,530,30567,0
5330,107.6705126,8.277310924,196.3361345,2521.092437,25404,4345,672,30421,1
5331,33.70615385,6.153846154,120.1538462,1750.615385,21483,7962,930,30375,0
5332,31.5255,5.166666667,109.6666667,1861.833333,21654,7610,1045,30309,0
5333,62.39565385,4.384615385,135.5,2972.307692,23476,5333,1369,30178,0
5334,22.78208333,4.916666667,81.66666667,1847.666667,18477,9546,972,28995,0
5335,59.0,7.0,166.0,1798.0,20345,6390,1531,28266,0
5336,6.050333333,4.333333333,52.0,1335.0,18416,9078,597,28091,0
5337,27.78966667,4.666666667,110.6666667,2050.333333,18124,8775,1121,28020,0
5338,78.07322727,7.672727273,192.4,2598.818182,22281,4145,1523,27949,0
5339,36.38445588,4.5,125.7058824,2294.764706,21650,4024,1799,27473,0
5340,14.293,4.6,75.4,1479.0,16008,9318,778,26104,0
5341,20.49710714,4.142857143,72.42857143,1824.428571,18847,5722,1073,25642,0
5342,34.19,6.0,103.0,1794.0,15901,8385,982,25268,0
5343,107.6705126,8.277310924,196.3361345,2521.092437,19595,3987,954,24536,1
5344,12.47666667,4.666666667,58.66666667,1498.0,15763,7768,1000,24531,0
5345,28.60820513,4.756410256,92.82051282,2043.820513,19790,3319,1003,24112,0
5346,11.389,4.142857143,53.0,1308.285714,10163,12923,848,23934,0
5347,10.32442857,4.142857143,54.35714286,1463.857143,13896,8829,571,23296,0
5348,17.03876744,5.302325581,73.48837209,1374.046512,11277,10981,869,23127,0
5349,16.67175,4.5,74.0,1541.5,15477,6414,1039,22930,0
5350,19.08518182,3.727272727,68.90909091,1180.545455,10765,10996,696,22457,0
5351,15.46,5.0,60.8,1196.0,8469,12666,1234,22369,0
5352,30.0062,3.2,115.4666667,2245.6,17905,3510,802,22217,0
5353,115.533,8.0,250.0,2998.0,18972,2441,787,22200,0
5354,17.22277778,4.888888889,70.0,1615.333333,13703,6684,745,21132,0
5355,16.4455,4.666666667,78.0,1741.0,15988,4610,468,21066,0
5356,25.08266667,4.533333333,93.6,2127.333333,15790,3344,561,19695,0
5357,12.61125,4.5,56.25,1607.25,14344,4462,517,19323,0
5358,57.92693548,6.161290323,149.7096774,2283.112903,14726,3125,1139,18990,0
5359,33.25025,6.166666667,112.75,1475.0,10781,7418,553,18752,0
5360,11.49625,4.75,50.25,1507.5,12029,5985,483,18497,0
5361,43.54851613,1.35483871,137.7741935,2261.193548,8992,7577,1016,17585,0
5362,21.407,4.5,72.0,1974.0,11815,4766,598,17179,0
5363,37.46857143,5.857142857,103.4285714,1718.571429,8350,7351,1148,16849,0
5364,11.81928571,4.619047619,56.85714286,1520.952381,11138,5228,398,16764,0
5365,17.91985714,4.19047619,64.47619048,1759.190476,12837,3489,412,16738,0
5366,20.65665217,4.956521739,67.0,2234.26087,12349,3472,850,16671,0
5367,9.358333333,4.333333333,47.0,1324.0,7706,8244,547,16497,0
5368,36.35965,4.55,110.5,2345.1,13170,1965,578,15713,0
5369,23.16515789,3.947368421,82.15789474,1817.315789,9923,4812,930,15665,0
5370,30.86290909,4.454545455,105.5454545,2458.909091,12595,1431,408,14434,0
5371,43.08,4.666666667,105.0,2239.666667,9170,3435,797,13402,0
5372,35.86943902,5.585365854,117.0243902,1980.634146,10672,2143,436,13251,0
5373,53.78571429,6.0,124.8571429,1855.0,8739,3285,844,12868,1
5374,11.9845625,4.0,69.0,1762.75,10231,2275,216,12722,0
5375,37.52210345,3.896551724,107.3793103,2084.37931,8553,3042,1087,12682,0
5376,8.4656,4.6,41.4,1182.4,7139,4924,349,12412,0
5377,3.3322,4.6,15.6,469.6,7990,3519,218,11727,0
5378,11.745,5.0,51.0,998.0,4942,5756,792,11490,0
5379,20.37,5.642857143,74.21428571,1324.357143,9044,2141,292,11477,0
5380,29.151,5.0,89.0,2526.5,7911,2575,376,10862,0
5381,24.84,5.0,102.0,2244.0,7893,2482,343,10718,0
5382,12.84981818,4.636363636,57.36363636,1849.545455,8203,2252,226,10681,0
5383,28.379,4.6,91.6,2181.2,8161,1700,310,10171,0
5384,23.01661538,4.730769231,90.88461538,1709.538462,6705,3079,318,10102,0
5385,8.400222222,4.333333333,44.55555556,1350.0,5962,3883,241,10086,0
5386,22.455,6.0,92.30769231,1466.307692,6079,3242,343,9664,0
5387,22.95383333,5.0,67.33333333,1908.166667,6461,2772,414,9647,0
5388,17.5296,4.6,78.4,1549.8,6238,2834,321,9393,0
5389,18.16715385,4.692307692,70.30769231,1932.153846,6859,1792,451,9102,0
5390,81.295,8.0,250.0,2998.0,7420,1296,223,8939,0
5391,16.80266667,4.5,71.0,1764.0,7139,1483,308,8930,0
5392,59.4905,5.0,137.5,2734.5,6915,1485,297,8697,0
5393,13.191,5.0,51.33333333,1431.333333,3380,4920,366,8666,0
5394,6.494,5.0,30.0,903.0,3132,5101,253,8486,0
5395,30.5976,1.8,97.6,1757.6,5407,2072,637,8116,0
5396,158.7922667,7.466666667,293.5333333,3005.4,6878,788,308,7974,0
5397,37.01736842,4.736842105,97.57894737,2697.368421,5846,1827,254,7927,1
5398,12.73581818,4.636363636,54.0,1559.181818,5756,1893,172,7821,0
5399,13.818,5.0,66.0,1351.0,5692,1626,256,7574,0
5400,22.127,5.0,83.0,1721.5,3801,3355,407,7563,0
5401,35.34,5.0,118.0,1781.0,5666,1396,374,7436,0
5402,11.263,4.5,55.0,1597.0,5739,1281,119,7139,0
5403,22.69,4.8,82.2,1773.7,5221,1323,231,6775,0
5404,9.999666667,4.333333333,49.33333333,1347.666667,4234,2157,213,6604,0
5405,3.781,4.0,18.0,652.0,2538,3763,175,6476,0
5406,13.31085714,4.089285714,53.33928571,1518.678571,4086,2136,151,6373,0
5407,35.25972727,4.727272727,104.6363636,2367.181818,5215,804,230,6249,0
5408,40.7645,4.333333333,133.3333333,2634.222222,5027,807,336,6170,0
5409,35.28132353,5.176470588,113.3529412,2106.5,4622,1070,361,6053,0
5410,34.33029412,5.588235294,105.0,1962.058824,4873,1048,128,6049,1
5411,17.31241935,4.967741935,66.35483871,1655.741935,4282,1608,153,6043,0
5412,31.79107143,4.571428571,104.1428571,2211.071429,5030,641,244,5915,0
5413,35.81481651,6.293577982,117.4311927,1921.46789,4006,1460,371,5837,0
5414,21.01833333,4.666666667,66.0,1206.0,4442,1269,125,5836,0
5415,9.58,4.5,61.66666667,1668.333333,4004,1493,137,5634,0
5416,6.895,5.0,46.0,1289.0,3893,1590,111,5594,0
5417,17.587,4.083333333,73.08333333,1363.5,3585,1797,151,5533,0
5418,38.39725,4.75,131.0,2652.375,4649,592,225,5466,0
5419,82.06090909,7.727272727,199.7272727,2790.454545,4457,628,304,5389,1
5420,45.6995,6.0,114.0,1854.2,3393,1195,374,4962,1
5421,38.48247059,4.882352941,90.94117647,2953.588235,3913,802,118,4833,1
5422,69.397,5.0,173.0,3358.666667,3696,585,195,4476,0
5423,11.34,4.0,74.0,1985.0,3408,874,179,4461,0
5424,8.118,4.0,51.5,1487.5,3448,929,66,4443,0
5425,31.7425,4.833333333,119.6666667,2116.0,3708,622,102,4432,0
5426,9.5628,4.6,50.0,996.0,1576,2723,133,4432,0
5427,5.758,4.0,43.0,1275.0,3346,1013,63,4422,0
5428,28.9602,4.4,100.8,1936.6,3487,684,189,4360,0
5429,36.21929825,6.473684211,94.33333333,1424.666667,2624,1393,274,4291,0
5430,14.76166667,4.666666667,75.0,1594.0,3023,1066,125,4214,0
5431,19.71783333,4.0,98.0,1995.0,2968,910,161,4039,0
5432,14.275,5.0,70.0,1997.0,2569,1356,98,4023,1
5433,29.043,5.851851852,105.0740741,1638.888889,3016,713,86,3815,0
5434,12.241,5.0,57.0,1568.0,2749,779,71,3599,0
5435,135.1055,6.5,309.0,3999.0,3133,340,107,3580,0
5436,39.7374,4.6,115.0,2234.4,2245,1113,168,3526,0
5437,17.182,5.0,74.0,1994.0,3049,374,60,3483,0
5438,30.92666667,4.666666667,110.3333333,2328.333333,2500,824,156,3480,0
5439,43.9745,4.5,98.0,2309.0,2746,571,98,3415,0
5440,114.8758333,8.0,235.0,2979.0,2839,419,105,3363,0
5441,12.25,5.0,43.0,1325.0,1797,1459,100,3356,0
5442,34.10357143,4.571428571,121.8571429,2555.285714,2659,372,145,3176,0
5443,264.675,7.0,420.0,6208.0,2244,695,109,3048,0
5444,145.6466667,6.0,283.0,5000.0,2547,281,115,2943,0
5445,43.06842105,6.254385965,104.2017544,2222.710526,2414,257,172,2843,1
5446,4.626333333,4.0,34.0,1046.0,1786,943,46,2775,0
5447,13.137,5.0,93.5,1998.0,2113,452,96,2661,0
5448,43.9745,4.5,98.0,2309.0,1529,998,125,2652,0
5449,18.6532,4.6,74.8,2652.8,2136,353,53,2542,1
5450,30.3775,6.3125,94.0625,935.625,1382,919,122,2423,0
5451,14.93453333,4.333333333,59.6,1655.066667,1891,442,50,2383,0
5452,23.90933333,5.0,100.6666667,2016.777778,2006,287,81,2374,0
5453,50.96109091,6.181818182,135.2909091,1971.163636,1761,421,149,2331,1
5454,43.97,6.6,115.3,1634.2,1597,652,67,2316,1
5455,15.11811765,4.588235294,61.76470588,1603.117647,1764,453,54,2271,0
5456,110.0985,5.0,235.0,4957.0,1868,252,83,2203,0
5457,29.57028571,5.0,84.0,1997.142857,1529,512,153,2194,1
5458,55.2,6.0,163.5,2696.5,1537,495,122,2154,0
5459,15.764,5.0,66.0,1497.0,1016,1015,83,2114,0
5460,50.143,5.818181818,155.5454545,2799.272727,1761,266,64,2091,0
5461,71.602,4.0,149.0,3590.0,1781,222,68,2071,0
5462,15.6985,4.5,73.0,1590.0,1421,546,73,2040,0
5463,23.16515789,3.947368421,82.15789474,1817.315789,1317,604,88,2009,0
5464,17.42714286,5.0,87.71428571,1696.428571,1346,558,101,2005,0
5465,38.79428571,4.428571429,98.57142857,2755.571429,1536,365,86,1987,1
5466,18.19842857,5.0,87.71428571,1696.428571,1390,480,103,1973,0
5467,10.54685714,5.0,49.42857143,1418.428571,1301,588,44,1933,0
5468,21.76576923,5.0,81.69230769,1808.384615,1533,301,62,1896,0
5469,49.82277778,6.0,115.8333333,1746.944444,1368,395,127,1890,0
5470,25.29875,4.5,94.0,1998.0,1275,528,81,1884,0
5471,36.70125,4.875,91.75,2019.75,1111,649,89,1849,0
5472,30.081,4.0,110.0,2254.0,1141,606,90,1837,0
5473,61.86283333,6.833333333,184.1666667,2748.333333,1151,546,103,1800,0
5474,61.235,5.0,147.0,2144.0,1515,169,51,1735,0
5475,6.587333333,4.0,22.33333333,932.6666667,872,710,130,1712,0
5476,134.789,8.0,390.0,4395.0,1497,156,46,1699,0
5477,13.2218,4.6,70.2,1736.2,1254,377,40,1671,0
5478,20.1241875,4.875,79.875,1836.875,1248,317,50,1615,0
5479,646.605,6.0,450.0,5733.0,1248,157,49,1454,0
5480,108.7471951,7.853658537,207.6097561,2304.97561,1186,185,81,1452,1
5481,7.55925,4.0,38.75,1137.75,853,546,38,1437,0
5482,93.42433333,5.0,233.0,2995.0,1251,83,28,1362,0
5483,32.99,5.0,132.0,2969.0,1182,143,24,1349,0
5484,7.508333333,4.0,36.66666667,1099.0,720,597,31,1348,0
5485,31.46033929,6.011904762,93.93452381,2037.27381,902,333,43,1278,1
5486,13.43333333,4.333333333,67.66666667,1527.0,995,236,38,1269,0
5487,106.82,4.0,234.0,5993.0,1051,110,69,1230,0
5488,36.166625,4.375,117.625,2849.25,1034,154,20,1208,0
5489,76.71,0.0,336.0,0.0,967,173,55,1195,0
5490,6.239,5.0,37.0,1049.0,645,520,25,1190,0
5491,38.66975,4.3,95.65,2027.9,1001,143,28,1172,0
5492,92.798,4.0,166.0,3980.0,994,94,48,1136,0
5493,16.74091176,4.117647059,71.47058824,2066.176471,952,158,19,1129,0
5494,15.8783125,4.25,84.4375,2161.625,898,175,23,1096,0
5495,13.24516667,4.833333333,66.66666667,1506.5,685,345,46,1076,0
5496,18.53214286,5.714285714,68.57142857,1166.142857,737836,782479,39028,1559343,0
5497,16.20874359,4.461538462,63.56410256,1650.205128,989746,501907,35418,1527071,0
5498,18.2955625,4.875,70.25,1836.5,697196,150162,14365,861723,0
5499,17.182,5.0,74.0,1994.0,423581,141003,15783,580367,0
5500,31.24215385,6.164835165,89.46153846,1537.406593,268499,173409,21896,463804,0
5501,20.3776087,4.869565217,67.95652174,1279.695652,173028,236732,14325,424085,0
5502,15.40377778,5.0,60.11111111,1593.111111,290137,94099,6248,390484,0
5503,18.1925,5.074074074,60.96296296,1408.055556,153180,174444,14041,341665,0
5504,13.11525,4.75,50.875,1430.75,160695,167026,13622,341343,0
5505,47.84837037,6.444444444,126.1111111,1995.777778,185091,66098,10136,261325,0
5506,18.84548718,4.076923077,87.07692308,2326.358974,209138,29783,3885,242806,0
5507,20.43008333,4.791666667,69.875,1773.0,187714,39451,6671,233836,0
5508,39.97375,1.75,130.25,1998.5,169645,33653,5486,208784,0
5509,22.1,5.615384615,75.57692308,1219.653846,82952,116732,8352,208036,0
5510,11.28285714,4.285714286,49.28571429,1337.714286,91074,97082,5938,194094,0
5511,14.350125,4.875,59.5,1642.875,117076,55606,5037,177719,0
5512,10.83275,5.0,45.0,1242.0,73399,96160,5953,175512,0
5513,27.23911864,3.033898305,91.61016949,1677.949153,102985,57338,5992,166315,0
5514,12.35588235,4.647058824,53.88235294,1366.294118,60825,93285,6395,160505,0
5515,29.942625,4.5,106.225,1480.575,80718,65782,6962,153462,0
5516,14.4382,4.9,64.2,1891.7,116178,25909,3214,145301,0
5517,17.44569231,4.692307692,68.26923077,1791.230769,99156,23223,4548,126927,0
5518,18.64264,4.84,67.0,1698.64,76406,42153,5854,124413,0
5519,16.29053333,4.8,57.86666667,1645.133333,81679,32711,3643,118033,0
5520,16.05676923,4.923076923,67.0,1703.153846,68381,30517,4596,103494,0
5521,20.27896296,4.111111111,72.85185185,1832.888889,70062,26845,4726,101633,0
5522,93.71425,8.0,225.0,2979.0,81009,15010,3568,99587,0
5523,17.34364706,4.745098039,70.92156863,1683.607843,57631,38240,3553,99424,0
5524,39.39984314,5.784313725,117.7058824,2151.647059,72661,20571,4284,97516,0
5525,46.06451282,6.487179487,125.4358974,1835.846154,69434,17473,3912,90819,0
5526,27.09825,4.666666667,91.75,2247.333333,68155,15799,3161,87115,0
5527,26.51269565,4.02173913,93.58695652,1933.021739,69041,15333,2718,87092,0
5528,20.35378947,4.789473684,67.68421053,1996.684211,66985,17164,2702,86851,0
5529,10.42388889,5.0,52.44444444,1095.777778,34228,48565,2831,85624,0
5530,20.7195,4.71875,81.375,1950.90625,55754,12287,1976,70017,0
5531,107.4521429,8.0,182.5714286,2425.428571,48341,10983,2727,62051,1
5532,23.585,5.8125,80.8125,1446.125,40134,19984,1928,62046,1
5533,37.00904545,4.590909091,114.6818182,2208.090909,42326,11244,3473,57043,0
5534,36.64326667,4.466666667,88.73333333,2284.133333,41948,11829,2575,56352,0
5535,19.93814035,5.649122807,76.31578947,1205.192982,28124,22573,1484,52181,0
5536,11.63114286,4.428571429,47.14285714,1477.0,33017,17841,1321,52179,0
5537,137.5695455,8.0,223.5454545,2813.0,41842,5522,1624,48988,0
5538,11.7129,4.0,69.0,1864.8,38743,7679,620,47042,0
5539,7.863333333,5.0,44.0,1289.0,32623,13006,1048,46677,0
5540,31.30566667,6.259259259,96.92592593,1587.222222,32274,11037,1376,44687,0
5541,24.84390244,4.756097561,84.92682927,1982.756098,35677,6149,1889,43715,0
5542,41.616,4.6,125.36,2336.52,33354,5487,2328,41169,0
5543,34.02059211,5.552631579,99.0,1920.026316,31864,6360,1340,39564,1
5544,37.32636,4.76,101.12,2349.08,31263,5685,1365,38313,0
5545,22.35277778,4.222222222,80.92592593,1977.259259,31369,5919,885,38173,0
5546,6.050333333,4.333333333,52.0,1335.0,24732,11871,775,37378,0
5547,7.92,4.0,33.33333333,868.3333333,13313,22247,1212,36772,0
5548,10.9158,5.0,49.8,1372.4,26637,8180,545,35362,0
5549,33.70615385,6.153846154,120.1538462,1750.615385,23258,8981,998,33237,0
5550,26.803,5.428571429,85.71428571,1310.0,17513,14187,1159,32859,0
5551,107.6705126,8.277310924,196.3361345,2521.092437,26288,4554,752,31594,1
5552,30.236875,4.5,110.0,2316.0,24679,5013,1774,31466,0
5553,7.712,5.0,29.0,899.0,11890,18226,1236,31352,0
5554,62.39565385,4.384615385,135.5,2972.307692,22996,5163,1336,29495,0
5555,31.5255,5.166666667,109.6666667,1861.833333,21148,7136,938,29222,0
5556,27.78966667,4.666666667,110.6666667,2050.333333,17452,8633,1097,27182,0
5557,46.5274,7.04,131.6,1596.92,19807,4871,1458,26136,0
5558,10.32442857,4.142857143,54.35714286,1463.857143,15195,9310,592,25097,0
5559,59.0,7.0,166.0,1798.0,18135,5371,1443,24949,0
5560,20.49710714,4.142857143,72.42857143,1824.428571,18252,5252,1079,24583,0
5561,11.81928571,4.619047619,56.85714286,1520.952381,16332,7437,553,24322,0
5562,34.19,6.0,103.0,1794.0,14850,8140,989,23979,0
5563,11.49625,4.75,50.25,1507.5,15112,7579,535,23226,0
5564,12.61125,4.5,56.25,1607.25,17166,5227,642,23035,0
5565,16.67175,4.5,74.0,1541.5,15684,6177,1073,22934,0
5566,30.0062,3.2,115.4666667,2245.6,18064,3500,780,22344,0
5567,17.03876744,5.302325581,73.48837209,1374.046512,10687,9972,814,21473,0
5568,36.38445588,4.5,125.7058824,2294.764706,16919,3011,1500,21430,0
5569,115.533,8.0,250.0,2998.0,17800,2351,666,20817,0
5570,107.6705126,8.277310924,196.3361345,2521.092437,16285,3271,792,20348,1
5571,33.25025,6.166666667,112.75,1475.0,11685,8015,594,20294,0
5572,19.08518182,3.727272727,68.90909091,1180.545455,9605,9571,595,19771,0
5573,78.07322727,7.672727273,192.4,2598.818182,15102,2726,1059,18887,0
5574,25.08266667,4.533333333,93.6,2127.333333,15241,3111,534,18886,0
5575,20.65665217,4.956521739,67.0,2234.26087,13868,3745,961,18574,0
5576,11.389,4.142857143,53.0,1308.285714,7785,9613,570,17968,0
5577,21.407,4.5,72.0,1974.0,12323,4836,614,17773,0
5578,11.370625,5.0,48.0,1518.0,11898,4528,506,16932,0
5579,26.4498867,5.408866995,87.31034483,1623.793103,10371,5748,729,16848,0
5580,11.9845625,4.0,69.0,1762.75,13289,3037,269,16595,0
5581,17.91985714,4.19047619,64.47619048,1759.190476,12871,3206,418,16495,0
5582,16.4455,4.666666667,78.0,1741.0,12527,3283,370,16180,0
5583,3.3322,4.6,15.6,469.6,10763,4801,275,15839,0
5584,12.47666667,4.666666667,58.66666667,1498.0,10178,4462,777,15417,0
5585,8.400222222,4.333333333,44.55555556,1350.0,8883,5846,386,15115,0
5586,9.358333333,4.333333333,47.0,1324.0,7205,7366,469,15040,0
5587,12.84981818,4.636363636,57.36363636,1849.545455,11445,3240,325,15010,0
5588,36.35965,4.55,110.5,2345.1,12679,1732,567,14978,0
5589,23.16515789,3.947368421,82.15789474,1817.315789,8914,4168,861,13943,0
5590,14.293,4.6,75.4,1479.0,8641,4739,394,13774,0
5591,35.86943902,5.585365854,117.0243902,1980.634146,10872,2149,457,13478,0
5592,8.4656,4.6,41.4,1182.4,7482,5353,346,13181,0
5593,22.78208333,4.916666667,81.66666667,1847.666667,8418,4261,437,13116,0
5594,43.54851613,1.35483871,137.7741935,2261.193548,6759,5064,700,12523,0
5595,37.46857143,5.857142857,103.4285714,1718.571429,5798,4752,872,11422,0
5596,57.92693548,6.161290323,149.7096774,2283.112903,8678,1660,702,11040,0
5597,12.73581818,4.636363636,54.0,1559.181818,8133,2661,235,11029,0
5598,30.86290909,4.454545455,105.5454545,2458.909091,9638,1062,307,11007,0
5599,37.52210345,3.896551724,107.3793103,2084.37931,7487,2532,974,10993,0
5600,11.745,5.0,51.0,998.0,4827,5394,755,10976,0
5601,43.08,4.666666667,105.0,2239.666667,7481,2667,669,10817,0
5602,28.379,4.6,91.6,2181.2,8437,1713,336,10486,0
5603,23.01661538,4.730769231,90.88461538,1709.538462,6963,2978,316,10257,0
5604,20.37,5.642857143,74.21428571,1324.357143,7912,1769,260,9941,0
5605,17.5296,4.6,78.4,1549.8,6521,2848,351,9720,0
5606,24.84,5.0,102.0,2244.0,7074,2108,300,9482,0
5607,12.32981818,4.818181818,53.81818182,1367.272727,4143,4777,373,9293,0
5608,29.151,5.0,89.0,2526.5,6570,2054,318,8942,0
5609,81.295,8.0,250.0,2998.0,7300,1311,229,8840,0
5610,59.4905,5.0,137.5,2734.5,6949,1509,322,8780,0
5611,13.31085714,4.089285714,53.33928571,1518.678571,5597,2893,186,8676,0
5612,6.494,5.0,30.0,903.0,3288,5159,229,8676,0
5613,9.58,4.5,61.66666667,1668.333333,6114,2199,200,8513,0
5614,11.263,4.5,55.0,1597.0,6794,1420,143,8357,0
5615,13.818,5.0,66.0,1351.0,6181,1822,294,8297,0
5616,9.999666667,4.333333333,49.33333333,1347.666667,5213,2772,256,8241,0
5617,18.16715385,4.692307692,70.30769231,1932.153846,6242,1539,409,8190,0
5618,28.60820513,4.756410256,92.82051282,2043.820513,6813,981,353,8147,0
5619,3.781,4.0,18.0,652.0,3128,4817,199,8144,0
5620,6.895,5.0,46.0,1289.0,5350,2211,153,7714,0
5621,13.191,5.0,51.33333333,1431.333333,2981,4254,322,7557,0
5622,22.95383333,5.0,67.33333333,1908.166667,4906,2096,334,7336,0
5623,53.78571429,6.0,124.8571429,1855.0,5007,1804,466,7277,1
5624,35.34,5.0,118.0,1781.0,5317,1387,395,7099,0
5625,8.118,4.0,51.5,1487.5,5385,1412,104,6901,0
5626,158.7922667,7.466666667,293.5333333,3005.4,5888,673,241,6802,0
5627,34.33029412,5.588235294,105.0,1962.058824,5534,1120,140,6794,1
5628,21.01833333,4.666666667,66.0,1206.0,4933,1497,139,6569,0
5629,5.758,4.0,43.0,1275.0,4835,1445,99,6379,0
5630,17.22277778,4.888888889,70.0,1615.333333,4029,1702,213,5944,0
5631,35.25972727,4.727272727,104.6363636,2367.181818,5017,652,219,5888,0
5632,14.275,5.0,70.0,1997.0,3683,1979,145,5807,1
5633,37.01736842,4.736842105,97.57894737,2697.368421,4313,1280,192,5785,1
5634,22.127,5.0,83.0,1721.5,2878,2469,310,5657,0
5635,11.34,4.0,74.0,1985.0,4223,1065,225,5513,0
5636,40.7645,4.333333333,133.3333333,2634.222222,4408,658,302,5368,0
5637,16.80266667,4.5,71.0,1764.0,4120,716,245,5081,0
5638,38.39725,4.75,131.0,2652.375,4369,492,208,5069,0
5639,30.5976,1.8,97.6,1757.6,3223,1346,443,5012,0
5640,38.48247059,4.882352941,90.94117647,2953.588235,3830,736,122,4688,1
5641,31.79107143,4.571428571,104.1428571,2211.071429,3932,450,213,4595,0
5642,17.31241935,4.967741935,66.35483871,1655.741935,3182,1168,122,4472,0
5643,17.182,5.0,74.0,1994.0,3787,477,78,4342,0
5644,29.043,5.851851852,105.0740741,1638.888889,3349,836,115,4300,0
5645,69.397,5.0,173.0,3358.666667,3511,550,189,4250,0
5646,22.455,6.0,92.30769231,1466.307692,2678,1410,158,4246,0
5647,9.5628,4.6,50.0,996.0,1473,2590,121,4184,0
5648,43.9745,4.5,98.0,2309.0,3375,675,97,4147,0
5649,12.241,5.0,57.0,1568.0,3042,840,97,3979,0
5650,4.626333333,4.0,34.0,1046.0,2518,1340,69,3927,0
5651,31.7425,4.833333333,119.6666667,2116.0,3171,490,94,3755,0
5652,114.8758333,8.0,235.0,2979.0,2918,440,98,3456,0
5653,12.25,5.0,43.0,1325.0,1841,1454,88,3383,0
5654,28.9602,4.4,100.8,1936.6,2618,483,149,3250,0
5655,82.06090909,7.727272727,199.7272727,2790.454545,2616,372,186,3174,1
5656,15.11811765,4.588235294,61.76470588,1603.117647,2462,610,59,3131,0
5657,17.587,4.083333333,73.08333333,1363.5,2000,951,89,3040,0
5658,14.93453333,4.333333333,59.6,1655.066667,2332,547,69,2948,0
5659,13.137,5.0,93.5,1998.0,2277,525,96,2898,0
5660,30.92666667,4.666666667,110.3333333,2328.333333,2060,634,128,2822,0
5661,18.6532,4.6,74.8,2652.8,2288,388,53,2729,1
5662,135.1055,6.5,309.0,3999.0,2239,262,85,2586,0
5663,14.76166667,4.666666667,75.0,1594.0,1901,602,83,2586,0
5664,22.69,4.8,82.2,1773.7,1950,509,83,2542,0
5665,34.10357143,4.571428571,121.8571429,2555.285714,2059,280,130,2469,0
5666,13.2218,4.6,70.2,1736.2,1834,576,54,2464,0
5667,10.54685714,5.0,49.42857143,1418.428571,1611,722,53,2386,0
5668,264.675,7.0,420.0,6208.0,1642,505,82,2229,0
5669,50.143,5.818181818,155.5454545,2799.272727,1903,261,60,2224,0
5670,110.0985,5.0,235.0,4957.0,1895,241,74,2210,0
5671,45.6995,6.0,114.0,1854.2,1521,506,164,2191,1
5672,7.55925,4.0,38.75,1137.75,1284,821,57,2162,0
5673,6.587333333,4.0,22.33333333,932.6666667,1061,921,151,2133,0
5674,71.602,4.0,149.0,3590.0,1812,246,73,2131,0
5675,43.06842105,6.254385965,104.2017544,2222.710526,1787,185,123,2095,1
5676,7.508333333,4.0,36.66666667,1099.0,1086,920,47,2053,0
5677,15.6985,4.5,73.0,1590.0,1445,501,66,2012,0
5678,43.9745,4.5,98.0,2309.0,1160,745,98,2003,0
5679,21.76576923,5.0,81.69230769,1808.384615,1502,295,67,1864,0
5680,6.239,5.0,37.0,1049.0,979,813,45,1837,0
5681,15.46,5.0,60.8,1196.0,705,1018,87,1810,0
5682,61.235,5.0,147.0,2144.0,1521,169,55,1745,0
5683,23.16515789,3.947368421,82.15789474,1817.315789,1172,494,79,1745,0
5684,134.789,8.0,390.0,4395.0,1503,174,45,1722,0
5685,36.166625,4.375,117.625,2849.25,1428,225,23,1676,0
5686,16.74091176,4.117647059,71.47058824,2066.176471,1413,228,26,1667,0
5687,13.43333333,4.333333333,67.66666667,1527.0,1281,278,43,1602,0
5688,32.99,5.0,132.0,2969.0,1388,163,28,1579,0
5689,19.71783333,4.0,98.0,1995.0,1136,351,64,1551,0
5690,23.90933333,5.0,100.6666667,2016.777778,1288,174,56,1518,0
5691,55.2,6.0,163.5,2696.5,1069,319,93,1481,0
5692,30.081,4.0,110.0,2254.0,851,511,80,1442,0
5693,38.79428571,4.428571429,98.57142857,2755.571429,1145,236,61,1442,1
5694,646.605,6.0,450.0,5733.0,1196,170,52,1418,0
5695,15.764,5.0,66.0,1497.0,724,611,58,1393,0
5696,43.97,6.6,115.3,1634.2,980,362,39,1381,1
5697,35.28132353,5.176470588,113.3529412,2106.5,1100,207,74,1381,0
5698,93.42433333,5.0,233.0,2995.0,1250,80,31,1361,0
5699,108.7471951,7.853658537,207.6097561,2304.97561,1109,164,87,1360,1
5700,38.66975,4.3,95.65,2027.9,1135,184,38,1357,0
5701,18.97175,5.0,75.25,2214.5,1091,193,28,1312,1
5702,15.8783125,4.25,84.4375,2161.625,1038,220,31,1289,0
5703,145.6466667,6.0,283.0,5000.0,1161,77,45,1283,0
5704,106.82,4.0,234.0,5993.0,1101,118,60,1279,0
5705,17.42714286,5.0,87.71428571,1696.428571,871,333,64,1268,0
5706,29.57028571,5.0,84.0,1997.142857,832,248,95,1175,1
5707,35.81481651,6.293577982,117.4311927,1921.46789,797,274,95,1166,0
5708,4.968,3.5,59.0,1602.0,724,331,44,1099,0
5709,92.798,4.0,166.0,3980.0,924,100,45,1069,0
5710,18.19842857,5.0,87.71428571,1696.428571,752,259,57,1068,0
5711,16.20874359,4.461538462,63.56410256,1650.205128,980503,488318,32073,1500894,0
5712,18.53214286,5.714285714,68.57142857,1166.142857,720464,745296,34585,1500345,0
5713,18.2955625,4.875,70.25,1836.5,740899,150811,14277,905987,0
5714,17.182,5.0,74.0,1994.0,397309,120211,14031,531551,0
5715,31.24215385,6.164835165,89.46153846,1537.406593,252989,160288,20261,433538,0
5716,15.40377778,5.0,60.11111111,1593.111111,305892,93280,5959,405131,0
5717,20.3776087,4.869565217,67.95652174,1279.695652,164286,212813,12347,389446,0
5718,13.11525,4.75,50.875,1430.75,161304,165507,13598,340409,0
5719,18.1925,5.074074074,60.96296296,1408.055556,141989,157673,12371,312033,0
5720,18.84548718,4.076923077,87.07692308,2326.358974,212458,28816,3792,245066,0
5721,47.84837037,6.444444444,126.1111111,1995.777778,167492,57880,9008,234380,0
5722,20.43008333,4.791666667,69.875,1773.0,170585,33664,5934,210183,0
5723,11.28285714,4.285714286,49.28571429,1337.714286,97274,100224,5884,203382,0
5724,14.350125,4.875,59.5,1642.875,118973,53337,4975,177285,0
5725,22.1,5.615384615,75.57692308,1219.653846,68814,88798,6741,164353,0
5726,10.83275,5.0,45.0,1242.0,69310,86258,5434,161002,0
5727,27.23911864,3.033898305,91.61016949,1677.949153,99704,53149,5468,158321,0
5728,14.4382,4.9,64.2,1891.7,119473,24658,2978,147109,0
5729,39.97375,1.75,130.25,1998.5,114578,22055,3686,140319,0
5730,29.942625,4.5,106.225,1480.575,67107,56543,5716,129366,0
5731,12.35588235,4.647058824,53.88235294,1366.294118,48995,71481,4931,125407,0
5732,16.29053333,4.8,57.86666667,1645.133333,77367,29660,3504,110531,0
5733,17.44569231,4.692307692,68.26923077,1791.230769,86276,19255,3850,109381,0
5734,17.34364706,4.745098039,70.92156863,1683.607843,55830,35381,3142,94353,0
5735,20.27896296,4.111111111,72.85185185,1832.888889,65439,23999,4370,93808,0
5736,39.39984314,5.784313725,117.7058824,2151.647059,67616,19466,4124,91206,0
5737,10.42388889,5.0,52.44444444,1095.777778,36502,51615,2910,91027,0
5738,93.71425,8.0,225.0,2979.0,73753,13396,3119,90268,0
5739,16.05676923,4.923076923,67.0,1703.153846,58375,24691,3894,86960,0
5740,46.06451282,6.487179487,125.4358974,1835.846154,66379,16412,3796,86587,0
5741,20.35378947,4.789473684,67.68421053,1996.684211,67392,16131,2749,86272,0
5742,27.09825,4.666666667,91.75,2247.333333,67498,14951,3138,85587,0
5743,18.64264,4.84,67.0,1698.64,51210,26182,3850,81242,0
5744,26.51269565,4.02173913,93.58695652,1933.021739,54107,11136,2065,67308,0
5745,20.7195,4.71875,81.375,1950.90625,54039,11152,1884,67075,0
5746,23.585,5.8125,80.8125,1446.125,40316,18075,1818,60209,1
5747,11.63114286,4.428571429,47.14285714,1477.0,36310,19034,1406,56750,0
5748,11.7129,4.0,69.0,1864.8,45714,9195,663,55572,0
5749,36.64326667,4.466666667,88.73333333,2284.133333,39984,11073,2475,53532,0
5750,37.00904545,4.590909091,114.6818182,2208.090909,40220,10105,3196,53521,0
5751,107.4521429,8.0,182.5714286,2425.428571,39082,8500,2216,49798,1
5752,19.93814035,5.649122807,76.31578947,1205.192982,26031,20099,1141,47271,0
5753,7.863333333,5.0,44.0,1289.0,34055,12202,993,47250,0
5754,31.30566667,6.259259259,96.92592593,1587.222222,34420,11291,1480,47191,0
5755,6.050333333,4.333333333,52.0,1335.0,31122,14542,929,46593,0
5756,137.5695455,8.0,223.5454545,2813.0,38992,5260,1541,45793,0
5757,10.9158,5.0,49.8,1372.4,32627,9939,683,43249,0
5758,22.35277778,4.222222222,80.92592593,1977.259259,32765,5888,890,39543,0
5759,37.32636,4.76,101.12,2349.08,31704,5485,1371,38560,0
5760,41.616,4.6,125.36,2336.52,29310,4593,2102,36005,0
5761,33.70615385,6.153846154,120.1538462,1750.615385,24354,9514,1096,34964,0
5762,7.92,4.0,33.33333333,868.3333333,12620,20821,1118,34559,0
5763,11.81928571,4.619047619,56.85714286,1520.952381,22146,9647,673,32466,0
5764,107.6705126,8.277310924,196.3361345,2521.092437,26497,4529,739,31765,1
5765,24.84390244,4.756097561,84.92682927,1982.756098,24094,3805,1309,29208,0
5766,62.39565385,4.384615385,135.5,2972.307692,22332,4996,1276,28604,0
5767,31.5255,5.166666667,109.6666667,1861.833333,20800,6755,862,28417,0
5768,26.803,5.428571429,85.71428571,1310.0,15182,11746,953,27881,0
5769,11.49625,4.75,50.25,1507.5,17970,8600,569,27139,0
5770,12.61125,4.5,56.25,1607.25,19881,5992,771,26644,0
5771,27.78966667,4.666666667,110.6666667,2050.333333,17012,8487,1059,26558,0
5772,30.236875,4.5,110.0,2316.0,21034,3944,1546,26524,0
5773,10.32442857,4.142857143,54.35714286,1463.857143,16097,9263,568,25928,0
5774,34.19,6.0,103.0,1794.0,14067,7859,975,22901,0
5775,16.67175,4.5,74.0,1541.5,15712,5730,1090,22532,0
5776,20.49710714,4.142857143,72.42857143,1824.428571,16911,4514,1009,22434,0
5777,34.02059211,5.552631579,99.0,1920.026316,18146,3473,778,22397,1
5778,30.0062,3.2,115.4666667,2245.6,18263,3334,746,22343,0
5779,33.25025,6.166666667,112.75,1475.0,12386,8642,627,21655,0
5780,7.712,5.0,29.0,899.0,8218,12449,779,21446,0
5781,8.400222222,4.333333333,44.55555556,1350.0,12537,8090,482,21109,0
5782,59.0,7.0,166.0,1798.0,15241,4427,1321,20989,0
5783,11.9845625,4.0,69.0,1762.75,16211,3605,275,20091,0
5784,17.03876744,5.302325581,73.48837209,1374.046512,10249,8955,730,19934,0
5785,20.65665217,4.956521739,67.0,2234.26087,14973,3837,1053,19863,0
5786,3.3322,4.6,15.6,469.6,13542,5954,314,19810,0
5787,12.84981818,4.636363636,57.36363636,1849.545455,15153,4178,430,19761,0
5788,115.533,8.0,250.0,2998.0,16444,2145,587,19176,0
5789,25.08266667,4.533333333,93.6,2127.333333,14762,2769,497,18028,0
5790,21.407,4.5,72.0,1974.0,12430,4649,637,17716,0
5791,46.5274,7.04,131.6,1596.92,12656,3159,963,16778,0
5792,19.08518182,3.727272727,68.90909091,1180.545455,8170,7797,484,16451,0
5793,107.6705126,8.277310924,196.3361345,2521.092437,12934,2512,597,16043,1
5794,11.389,4.142857143,53.0,1308.285714,7042,8292,451,15785,0
5795,17.91985714,4.19047619,64.47619048,1759.190476,11564,2710,381,14655,0
5796,36.38445588,4.5,125.7058824,2294.764706,11014,1903,1016,13933,0
5797,12.73581818,4.636363636,54.0,1559.181818,10333,3254,248,13835,0
5798,8.4656,4.6,41.4,1182.4,7727,5402,352,13481,0
5799,9.358333333,4.333333333,47.0,1324.0,6777,6246,389,13412,0
5800,36.35965,4.55,110.5,2345.1,11343,1551,516,13410,0
5801,35.86943902,5.585365854,117.0243902,1980.634146,10511,2082,427,13020,0
5802,23.16515789,3.947368421,82.15789474,1817.315789,7735,3495,791,12021,0
5803,9.58,4.5,61.66666667,1668.333333,8682,2997,266,11945,0
5804,16.4455,4.666666667,78.0,1741.0,9318,2123,248,11689,0
5805,78.07322727,7.672727273,192.4,2598.818182,9364,1675,616,11655,0
5806,13.31085714,4.089285714,53.33928571,1518.678571,7492,3795,244,11531,0
5807,28.379,4.6,91.6,2181.2,8497,1628,336,10461,0
5808,8.118,4.0,51.5,1487.5,8117,2192,130,10439,0
5809,11.745,5.0,51.0,998.0,4547,4877,731,10155,0
5810,23.01661538,4.730769231,90.88461538,1709.538462,7025,2820,302,10147,0
5811,3.781,4.0,18.0,652.0,3646,5771,245,9662,0
5812,17.5296,4.6,78.4,1549.8,6585,2736,337,9658,0
5813,9.999666667,4.333333333,49.33333333,1347.666667,6182,3150,280,9612,0
5814,6.895,5.0,46.0,1289.0,6710,2647,171,9528,0
5815,37.52210345,3.896551724,107.3793103,2084.37931,6425,2140,869,9434,0
5816,11.263,4.5,55.0,1597.0,7680,1497,152,9329,0
5817,5.758,4.0,43.0,1275.0,6821,2012,122,8955,0
5818,13.818,5.0,66.0,1351.0,6567,1949,314,8830,0
5819,6.494,5.0,30.0,903.0,3360,5221,222,8803,0
5820,59.4905,5.0,137.5,2734.5,6877,1570,307,8754,0
5821,81.295,8.0,250.0,2998.0,7158,1295,231,8684,0
5822,43.08,4.666666667,105.0,2239.666667,5723,1939,541,8203,0
5823,37.46857143,5.857142857,103.4285714,1718.571429,4239,3262,611,8112,0
5824,20.37,5.642857143,74.21428571,1324.357143,6421,1397,210,8028,0
5825,14.275,5.0,70.0,1997.0,5047,2590,181,7818,1
5826,34.33029412,5.588235294,105.0,1962.058824,5956,1137,131,7224,1
5827,30.86290909,4.454545455,105.5454545,2458.909091,6237,634,225,7096,0
5828,21.01833333,4.666666667,66.0,1206.0,5198,1567,145,6910,0
5829,18.16715385,4.692307692,70.30769231,1932.153846,5007,1207,344,6558,0
5830,11.34,4.0,74.0,1985.0,4998,1215,242,6455,0
5831,43.54851613,1.35483871,137.7741935,2261.193548,3524,2521,336,6381,0
5832,29.151,5.0,89.0,2526.5,4690,1373,216,6279,0
5833,35.34,5.0,118.0,1781.0,4489,1245,338,6072,0
5834,24.84,5.0,102.0,2244.0,4555,1283,194,6032,0
5835,13.191,5.0,51.33333333,1431.333333,2326,3435,260,6021,0
5836,158.7922667,7.466666667,293.5333333,3005.4,4913,569,199,5681,0
5837,11.370625,5.0,48.0,1518.0,3977,1440,125,5542,0
5838,17.182,5.0,74.0,1994.0,4650,629,85,5364,0
5839,14.293,4.6,75.4,1479.0,3478,1683,152,5313,0
5840,22.95383333,5.0,67.33333333,1908.166667,3432,1432,248,5112,0
5841,4.626333333,4.0,34.0,1046.0,3261,1751,89,5101,0
5842,35.25972727,4.727272727,104.6363636,2367.181818,4331,530,209,5070,0
5843,29.043,5.851851852,105.0740741,1638.888889,3789,967,116,4872,0
5844,43.9745,4.5,98.0,2309.0,3885,784,109,4778,0
5845,9.5628,4.6,50.0,996.0,1566,2813,121,4500,0
5846,22.127,5.0,83.0,1721.5,2294,1859,226,4379,0
5847,38.39725,4.75,131.0,2652.375,3756,399,211,4366,0
5848,38.48247059,4.882352941,90.94117647,2953.588235,3564,680,100,4344,1
5849,12.241,5.0,57.0,1568.0,3291,902,99,4292,0
5850,40.7645,4.333333333,133.3333333,2634.222222,3426,475,253,4154,0
5851,15.11811765,4.588235294,61.76470588,1603.117647,3280,793,73,4146,0
5852,57.92693548,6.161290323,149.7096774,2283.112903,3222,554,265,4041,0
5853,12.47666667,4.666666667,58.66666667,1498.0,2767,983,280,4030,0
5854,69.397,5.0,173.0,3358.666667,3231,476,178,3885,0
5855,37.01736842,4.736842105,97.57894737,2697.368421,2799,742,120,3661,1
5856,114.8758333,8.0,235.0,2979.0,2975,460,96,3531,0
5857,13.2218,4.6,70.2,1736.2,2597,821,66,3484,0
5858,14.93453333,4.333333333,59.6,1655.066667,2750,609,84,3443,0
5859,31.79107143,4.571428571,104.1428571,2211.071429,2932,288,179,3399,0
5860,12.25,5.0,43.0,1325.0,1851,1377,80,3308,0
5861,31.7425,4.833333333,119.6666667,2116.0,2746,413,85,3244,0
5862,13.137,5.0,93.5,1998.0,2478,614,90,3182,0
5863,7.55925,4.0,38.75,1137.75,1870,1128,80,3078,0
5864,7.508333333,4.0,36.66666667,1099.0,1546,1338,77,2961,0
5865,30.5976,1.8,97.6,1757.6,1846,821,268,2935,0
5866,18.6532,4.6,74.8,2652.8,2351,423,49,2823,1
5867,6.239,5.0,37.0,1049.0,1428,1244,67,2739,0
5868,10.54685714,5.0,49.42857143,1418.428571,1836,802,49,2687,0
5869,6.587333333,4.0,22.33333333,932.6666667,1252,1112,177,2541,0
5870,17.31241935,4.967741935,66.35483871,1655.741935,1772,561,56,2389,0
5871,28.9602,4.4,100.8,1936.6,1877,334,121,2332,0
5872,16.74091176,4.117647059,71.47058824,2066.176471,1948,344,35,2327,0
5873,50.143,5.818181818,155.5454545,2799.272727,1916,278,63,2257,0
5874,110.0985,5.0,235.0,4957.0,1808,238,72,2118,0
5875,36.166625,4.375,117.625,2849.25,1783,292,34,2109,0
5876,71.602,4.0,149.0,3590.0,1751,235,67,2053,0
5877,30.92666667,4.666666667,110.3333333,2328.333333,1511,422,99,2032,0
5878,15.6985,4.5,73.0,1590.0,1445,474,72,1991,0
5879,13.43333333,4.333333333,67.66666667,1527.0,1521,326,45,1892,0
5880,34.10357143,4.571428571,121.8571429,2555.285714,1548,214,104,1866,0
5881,21.76576923,5.0,81.69230769,1808.384615,1458,278,61,1797,0
5882,82.06090909,7.727272727,199.7272727,2790.454545,1453,211,95,1759,1
5883,18.97175,5.0,75.25,2214.5,1437,267,32,1736,1
5884,32.99,5.0,132.0,2969.0,1521,185,29,1735,0
5885,16.80266667,4.5,71.0,1764.0,1455,200,74,1729,0
5886,61.235,5.0,147.0,2144.0,1500,153,58,1711,0
5887,134.789,8.0,390.0,4395.0,1438,159,47,1644,0
5888,135.1055,6.5,309.0,3999.0,1432,151,57,1640,0
5889,38.66975,4.3,95.65,2027.9,1280,178,38,1496,0
5890,4.968,3.5,59.0,1602.0,946,467,55,1468,0
5891,15.8783125,4.25,84.4375,2161.625,1187,246,35,1468,0
5892,22.78208333,4.916666667,81.66666667,1847.666667,1000,398,49,1447,0
5893,264.675,7.0,420.0,6208.0,1061,326,50,1437,0
5894,43.9745,4.5,98.0,2309.0,825,506,69,1400,0
5895,23.16515789,3.947368421,82.15789474,1817.315789,977,351,62,1390,0
5896,646.605,6.0,450.0,5733.0,1178,159,45,1382,0
5897,14.76166667,4.666666667,75.0,1594.0,1015,286,34,1335,0
5898,93.42433333,5.0,233.0,2995.0,1227,73,22,1322,0
5899,108.7471951,7.853658537,207.6097561,2304.97561,1052,163,89,1304,1
5900,43.06842105,6.254385965,104.2017544,2222.710526,1113,101,78,1292,1
5901,53.78571429,6.0,124.8571429,1855.0,905,278,92,1275,1
5902,106.82,4.0,234.0,5993.0,1089,126,59,1274,0
5903,9.18075,4.0,46.75,1324.5,769,423,37,1229,0
5904,30.081,4.0,110.0,2254.0,696,453,54,1203,0
5905,9.9475,4.75,73.5,1908.0,925,196,30,1151,0
5906,55.2,6.0,163.5,2696.5,776,242,80,1098,0
5907,23.90933333,5.0,100.6666667,2016.777778,855,109,47,1011,0
5908,16.20874359,4.461538462,63.56410256,1650.205128,1007113,489732,29926,1526771,0
5909,18.53214286,5.714285714,68.57142857,1166.142857,727636,733531,32401,1493568,0
5910,18.2955625,4.875,70.25,1836.5,781210,150663,14367,946240,0
5911,17.182,5.0,74.0,1994.0,366992,105185,12015,484192,0
5912,15.40377778,5.0,60.11111111,1593.111111,325282,92530,6021,423833,0
5913,31.24215385,6.164835165,89.46153846,1537.406593,246055,152217,19424,417696,0
5914,20.3776087,4.869565217,67.95652174,1279.695652,159997,196224,10990,367211,0
5915,13.11525,4.75,50.875,1430.75,161743,163289,13729,338761,0
5916,18.1925,5.074074074,60.96296296,1408.055556,143311,153292,11863,308466,0
5917,18.84548718,4.076923077,87.07692308,2326.358974,222665,28664,3797,255126,0
5918,47.84837037,6.444444444,126.1111111,1995.777778,156537,51976,8143,216656,0
5919,11.28285714,4.285714286,49.28571429,1337.714286,104462,103142,6014,213618,0
5920,14.350125,4.875,59.5,1642.875,122747,51720,5149,179616,0
5921,20.43008333,4.791666667,69.875,1773.0,145565,26771,5115,177451,0
5922,27.23911864,3.033898305,91.61016949,1677.949153,99755,50051,5236,155042,0
5923,14.4382,4.9,64.2,1891.7,125258,24245,2950,152453,0
5924,10.83275,5.0,45.0,1242.0,62170,72282,4784,139236,0
5925,22.1,5.615384615,75.57692308,1219.653846,53715,63942,5052,122709,0
5926,29.942625,4.5,106.225,1480.575,56368,48281,4754,109403,0
5927,10.42388889,5.0,52.44444444,1095.777778,40477,55940,3091,99508,0
5928,16.29053333,4.8,57.86666667,1645.133333,70149,25236,3283,98668,0
5929,17.44569231,4.692307692,68.26923077,1791.230769,76442,16534,3338,96314,0
5930,17.34364706,4.745098039,70.92156863,1683.607843,56914,34239,2994,94147,0
5931,39.39984314,5.784313725,117.7058824,2151.647059,66660,19612,4029,90301,0
5932,12.35588235,4.647058824,53.88235294,1366.294118,34850,48195,3324,86369,0
5933,20.35378947,4.789473684,67.68421053,1996.684211,67647,15289,2796,85732,0
5934,46.06451282,6.487179487,125.4358974,1835.846154,65183,15660,3802,84645,0
5935,93.71425,8.0,225.0,2979.0,69642,12114,2848,84604,0
5936,27.09825,4.666666667,91.75,2247.333333,66887,14173,2997,84057,0
5937,20.27896296,4.111111111,72.85185185,1832.888889,56519,19650,3792,79961,0
5938,39.97375,1.75,130.25,1998.5,65305,12030,2153,79488,0
5939,11.7129,4.0,69.0,1864.8,58188,11799,804,70791,0
5940,16.05676923,4.923076923,67.0,1703.153846,45114,17874,3001,65989,0
5941,20.7195,4.71875,81.375,1950.90625,53576,10402,1861,65839,0
5942,11.63114286,4.428571429,47.14285714,1477.0,40754,20473,1541,62768,0
5943,6.050333333,4.333333333,52.0,1335.0,40037,17726,1085,58848,0
5944,23.585,5.8125,80.8125,1446.125,37509,15436,1713,54658,1
5945,36.64326667,4.466666667,88.73333333,2284.133333,39172,10634,2459,52265,0
5946,37.00904545,4.590909091,114.6818182,2208.090909,39462,9454,2975,51891,0
5947,31.30566667,6.259259259,96.92592593,1587.222222,37849,12014,1679,51542,0
5948,26.51269565,4.02173913,93.58695652,1933.021739,40543,7787,1554,49884,0
5949,10.9158,5.0,49.8,1372.4,35653,10868,716,47237,0
5950,11.81928571,4.619047619,56.85714286,1520.952381,31568,13344,866,45778,0
5951,18.64264,4.84,67.0,1698.64,29261,13736,2057,45054,0
5952,137.5695455,8.0,223.5454545,2813.0,37411,4984,1424,43819,0
5953,19.93814035,5.649122807,76.31578947,1205.192982,23929,17552,953,42434,0
5954,7.863333333,5.0,44.0,1289.0,30961,9935,767,41663,0
5955,22.35277778,4.222222222,80.92592593,1977.259259,34310,5789,956,41055,0
5956,37.32636,4.76,101.12,2349.08,33128,5479,1419,40026,0
5957,33.70615385,6.153846154,120.1538462,1750.615385,26367,10611,1185,38163,0
5958,107.4521429,8.0,182.5714286,2425.428571,29292,6163,1776,37231,1
5959,107.6705126,8.277310924,196.3361345,2521.092437,27997,4708,780,33485,1
5960,11.49625,4.75,50.25,1507.5,21969,10122,662,32753,0
5961,12.61125,4.5,56.25,1607.25,24209,7147,916,32272,0
5962,7.92,4.0,33.33333333,868.3333333,11502,18971,978,31451,0
5963,41.616,4.6,125.36,2336.52,25479,3709,1946,31134,0
5964,8.400222222,4.333333333,44.55555556,1350.0,18434,11634,646,30714,0
5965,31.5255,5.166666667,109.6666667,1861.833333,21436,6711,818,28965,0
5966,62.39565385,4.384615385,135.5,2972.307692,22718,4881,1275,28874,0
5967,10.32442857,4.142857143,54.35714286,1463.857143,17251,9317,545,27113,0
5968,27.78966667,4.666666667,110.6666667,2050.333333,17079,8435,1041,26555,0
5969,12.84981818,4.636363636,57.36363636,1849.545455,20210,5461,556,26227,0
5970,33.25025,6.166666667,112.75,1475.0,14392,9889,687,24968,0
5971,11.9845625,4.0,69.0,1762.75,19936,4316,345,24597,0
5972,3.3322,4.6,15.6,469.6,16722,7364,368,24454,0
5973,30.0062,3.2,115.4666667,2245.6,18796,3224,749,22769,0
5974,26.803,5.428571429,85.71428571,1310.0,12461,9107,770,22338,0
5975,20.65665217,4.956521739,67.0,2234.26087,17039,4094,1153,22286,0
5976,34.19,6.0,103.0,1794.0,13639,7532,898,22069,0
5977,16.67175,4.5,74.0,1541.5,15145,5137,1074,21356,0
5978,30.236875,4.5,110.0,2316.0,16794,2935,1252,20981,0
5979,17.03876744,5.302325581,73.48837209,1374.046512,10362,8619,707,19688,0
5980,20.49710714,4.142857143,72.42857143,1824.428571,14247,3595,872,18714,0
5981,115.533,8.0,250.0,2998.0,16045,2069,551,18665,0
5982,21.407,4.5,72.0,1974.0,12893,4770,655,18318,0
5983,24.84390244,4.756097561,84.92682927,1982.756098,14732,2212,802,17746,0
5984,11.389,4.142857143,53.0,1308.285714,8043,9164,480,17687,0
5985,12.73581818,4.636363636,54.0,1559.181818,13147,4048,336,17531,0
5986,59.0,7.0,166.0,1798.0,12798,3517,1057,17372,0
5987,9.58,4.5,61.66666667,1668.333333,12643,4121,322,17086,0
5988,25.08266667,4.533333333,93.6,2127.333333,14098,2477,488,17063,0
5989,8.118,4.0,51.5,1487.5,13183,3523,201,16907,0
5990,13.31085714,4.089285714,53.33928571,1518.678571,10490,5117,322,15929,0
5991,5.758,4.0,43.0,1275.0,10882,3314,189,14385,0
5992,8.4656,4.6,41.4,1182.4,8142,5739,355,14236,0
5993,19.08518182,3.727272727,68.90909091,1180.545455,6700,6093,383,13176,0
5994,35.86943902,5.585365854,117.0243902,1980.634146,10337,1892,442,12671,0
5995,17.91985714,4.19047619,64.47619048,1759.190476,9999,2151,312,12462,0
5996,7.712,5.0,29.0,899.0,4743,7239,416,12398,0
5997,107.6705126,8.277310924,196.3361345,2521.092437,9974,1916,481,12371,1
5998,3.781,4.0,18.0,652.0,4482,6947,258,11687,0
5999,6.895,5.0,46.0,1289.0,8236,3142,203,11581,0
6000,9.999666667,4.333333333,49.33333333,1347.666667,7333,3811,343,11487,0
6001,14.275,5.0,70.0,1997.0,7403,3643,256,11302,1
6002,36.35965,4.55,110.5,2345.1,9570,1210,439,11219,0
6003,9.358333333,4.333333333,47.0,1324.0,5872,5011,324,11207,0
6004,11.263,4.5,55.0,1597.0,8986,1639,156,10781,0
6005,28.379,4.6,91.6,2181.2,8674,1602,364,10640,0
6006,23.16515789,3.947368421,82.15789474,1817.315789,6860,2921,732,10513,0
6007,23.01661538,4.730769231,90.88461538,1709.538462,7048,2641,303,9992,0
6008,17.5296,4.6,78.4,1549.8,6889,2672,349,9910,0
6009,11.745,5.0,51.0,998.0,4390,4644,713,9747,0
6010,13.818,5.0,66.0,1351.0,6919,2033,345,9297,0
6011,59.4905,5.0,137.5,2734.5,6952,1573,326,8851,0
6012,6.494,5.0,30.0,903.0,3473,5166,197,8836,0
6013,36.38445588,4.5,125.7058824,2294.764706,6956,1136,602,8694,0
6014,81.295,8.0,250.0,2998.0,7144,1216,244,8604,0
6015,46.5274,7.04,131.6,1596.92,6221,1609,495,8325,0
6016,16.4455,4.666666667,78.0,1741.0,6779,1303,180,8262,0
6017,11.34,4.0,74.0,1985.0,6229,1492,279,8000,0
6018,34.02059211,5.552631579,99.0,1920.026316,6423,1223,321,7967,1
6019,37.52210345,3.896551724,107.3793103,2084.37931,5308,1711,786,7805,0
6020,34.33029412,5.588235294,105.0,1962.058824,6398,1132,156,7686,1
6021,21.01833333,4.666666667,66.0,1206.0,5719,1641,145,7505,0
6022,17.182,5.0,74.0,1994.0,6258,914,96,7268,0
6023,4.626333333,4.0,34.0,1046.0,4196,2209,107,6512,0
6024,78.07322727,7.672727273,192.4,2598.818182,5146,913,346,6405,0
6025,43.08,4.666666667,105.0,2239.666667,4279,1444,415,6138,0
6026,37.46857143,5.857142857,103.4285714,1718.571429,3185,2357,469,6011,0
6027,13.191,5.0,51.33333333,1431.333333,2391,3343,233,5967,0
6028,15.11811765,4.588235294,61.76470588,1603.117647,4738,1111,103,5952,0
6029,43.9745,4.5,98.0,2309.0,4620,891,111,5622,0
6030,20.37,5.642857143,74.21428571,1324.357143,4526,935,125,5586,0
6031,29.043,5.851851852,105.0740741,1638.888889,4247,1118,150,5515,0
6032,158.7922667,7.466666667,293.5333333,3005.4,4444,539,204,5187,0
6033,13.2218,4.6,70.2,1736.2,3856,1203,106,5165,0
6034,9.5628,4.6,50.0,996.0,1802,3099,118,5019,0
6035,7.55925,4.0,38.75,1137.75,2838,1787,134,4759,0
6036,35.34,5.0,118.0,1781.0,3428,1000,280,4708,0
6037,6.239,5.0,37.0,1049.0,2421,2145,104,4670,0
6038,7.508333333,4.0,36.66666667,1099.0,2384,2115,138,4637,0
6039,12.241,5.0,57.0,1568.0,3482,891,97,4470,0
6040,18.16715385,4.692307692,70.30769231,1932.153846,3328,779,240,4347,0
6041,38.48247059,4.882352941,90.94117647,2953.588235,3434,665,85,4184,1
6042,30.86290909,4.454545455,105.5454545,2458.909091,3625,408,84,4117,0
6043,35.25972727,4.727272727,104.6363636,2367.181818,3442,390,165,3997,0
6044,14.93453333,4.333333333,59.6,1655.066667,3224,668,89,3981,0
6045,114.8758333,8.0,235.0,2979.0,3104,510,91,3705,0
6046,29.151,5.0,89.0,2526.5,2718,761,161,3640,0
6047,13.137,5.0,93.5,1998.0,2745,721,120,3586,0
6048,69.397,5.0,173.0,3358.666667,2980,428,165,3573,0
6049,38.39725,4.75,131.0,2652.375,2978,291,178,3447,0
6050,22.127,5.0,83.0,1721.5,1854,1390,186,3430,0
6051,16.74091176,4.117647059,71.47058824,2066.176471,2831,510,55,3396,0
6052,6.587333333,4.0,22.33333333,932.6666667,1613,1474,209,3296,0
6053,12.25,5.0,43.0,1325.0,1765,1256,80,3101,0
6054,22.95383333,5.0,67.33333333,1908.166667,2057,805,163,3025,0
6055,10.54685714,5.0,49.42857143,1418.428571,2122,811,65,2998,0
6056,18.6532,4.6,74.8,2652.8,2481,432,55,2968,1
6057,40.7645,4.333333333,133.3333333,2634.222222,2160,291,173,2624,0
6058,31.7425,4.833333333,119.6666667,2116.0,2225,304,73,2602,0
6059,36.166625,4.375,117.625,2849.25,2212,333,35,2580,0
6060,18.97175,5.0,75.25,2214.5,2062,355,42,2459,1
6061,13.43333333,4.333333333,67.66666667,1527.0,1871,390,52,2313,0
6062,50.143,5.818181818,155.5454545,2799.272727,1946,273,66,2285,0
6063,9.18075,4.0,46.75,1324.5,1351,770,58,2179,0
6064,110.0985,5.0,235.0,4957.0,1839,264,57,2160,0
6065,4.968,3.5,59.0,1602.0,1380,675,63,2118,0
6066,24.84,5.0,102.0,2244.0,1564,439,82,2085,0
6067,31.79107143,4.571428571,104.1428571,2211.071429,1771,165,120,2056,0
6068,71.602,4.0,149.0,3590.0,1698,230,70,1998,0
6069,32.99,5.0,132.0,2969.0,1752,219,24,1995,0
6070,15.6985,4.5,73.0,1590.0,1419,433,63,1915,0
6071,37.01736842,4.736842105,97.57894737,2697.368421,1449,345,67,1861,1
6072,38.66975,4.3,95.65,2027.9,1575,222,46,1843,0
6073,9.9475,4.75,73.5,1908.0,1475,313,52,1840,0
6074,61.235,5.0,147.0,2144.0,1523,166,52,1741,0
6075,15.8783125,4.25,84.4375,2161.625,1402,292,36,1730,0
6076,134.789,8.0,390.0,4395.0,1513,167,47,1727,0
6077,4.536,4.0,44.0,1198.0,1295,361,26,1682,0
6078,21.76576923,5.0,81.69230769,1808.384615,1397,215,58,1670,0
6079,28.9602,4.4,100.8,1936.6,1300,229,84,1613,0
6080,21.084,4.0,86.0,2202.0,1292,272,47,1611,0
6081,30.5976,1.8,97.6,1757.6,968,459,161,1588,0
6082,30.92666667,4.666666667,110.3333333,2328.333333,1121,294,80,1495,0
6083,106.82,4.0,234.0,5993.0,1152,129,67,1348,0
6084,93.42433333,5.0,233.0,2995.0,1215,88,27,1330,0
6085,646.605,6.0,450.0,5733.0,1130,158,42,1330,0
6086,34.10357143,4.571428571,121.8571429,2555.285714,1090,160,65,1315,0
6087,108.7471951,7.853658537,207.6097561,2304.97561,1012,150,80,1242,1
6088,43.54851613,1.35483871,137.7741935,2261.193548,670,482,66,1218,0
6089,55.2,6.0,163.5,2696.5,790,247,81,1118,0
6090,30.081,4.0,110.0,2254.0,639,416,49,1104,0
6091,23.16515789,3.947368421,82.15789474,1817.315789,721,251,40,1012,0
